Buchung;Valuta;Buchungstext;Belastung;Gutschrift;Saldo CHF;
30.06.2022;30.06.2022;Agnumultiustiaüin Entendo Velis ********4635 11.81.1772 - 13.81.1772;3.00;;60'498.16;
30.06.2022;30.06.2022;Taturyülicaraterüin Quattertury 7011.4313.3715 11.81.1772 - 13.81.1772;3.00;;60'501.16;
30.06.2022;30.06.2022;Nentianteritis;97.80;;60'504.16;
30.06.2022;30.06.2022;Hocüarem Simetubile Figauci;1.00;;60'601.96;
30.06.2022;30.06.2022;Amerrexpeneniffeseptur;83.85;;60'602.96;
30.06.2022;30.06.2022;Obsemple-Possubilia 35556442 - DEM Visu;;3'840.00;60'686.81;
30.06.2022;30.06.2022;" Dompotalitatete / Fer.-An. 3407850446 Maratus Schiuva ET ";;89.00;56'846.81;
30.06.2022;30.06.2022;" Dompotalitatete / Fer.-An. 7646814773 Maratus Schiuva ET ";;129.00;56'757.81;
30.06.2022;30.06.2022;" Dompotalitatete / Fer.-An. 7303588434 Maratus Schiuva ET ";;129.00;56'628.81;
30.06.2022;30.06.2022;" Dompotalitatete / Fer.-An. 7036565371 Maratus Schiuva ET ";;89.00;56'499.81;
30.06.2022;30.06.2022;" Dompotalitatete / Fer.-An. 1525808315 Maratus Schiuva ET ";;129.00;56'410.81;
30.06.2022;30.06.2022;" Dompotalitatete / Fer.-An. 1671716147 Maratus Schiuva ET ";;129.00;56'281.81;
30.06.2022;30.06.2022;" Dompotalitatete / Fer.-An. 7316884260 Maratus Schiuva ET ";;559.00;56'152.81;
30.06.2022;30.06.2022;" Dompotalitatete / Fer.-An. 1221006153 Maratus Schiuva ET ";;129.00;55'593.81;
30.06.2022;30.06.2022;" Dompotalitatete / Fer.-An. 3084088858 Maratus Schiuva ET ";;179.00;55'464.81;
30.06.2022;30.06.2022;" Dompotalitatete / Fer.-An. 7204868161 Maratus Schiuva ET ";;170.00;55'285.81;
30.06.2022;30.06.2022;" Dompotalitatete / Fer.-An. 6860424705 Maratus Schiuva ET ";;62.00;55'115.81;
30.06.2022;30.06.2022;" Dompotalitatete / Fer.-An. 1154005460 Maratus Schiuva ET ";;129.00;55'053.81;
30.06.2022;30.06.2022;" Detudidivigunno x-mulegar (Canent Reampagro: 4 / Fer.-An. 8346704226) ";8'407.25;;54'924.81;
30.06.2022;30.06.2022;" Duxertibi x-mulegar / Fer.-An. 8206155661 I. PERINI PETIA E/D ";2'536.66;;63'332.06;
30.06.2022;30.06.2022;" Duxertibi x-mulegar / Fer.-An. 3873441370 ";545.90;;65'868.72;
30.06.2022;30.06.2022;" Dompotalitatete / Fer.-An. 1651128315 PUENTABIT ALITTIS ET ";;19.76;66'414.62;
30.06.2022;29.06.2022;Espoturres xxx Cuproxitalevarae Scidedens-Brevelia O;5.00;;66'394.86;
29.06.2022;29.06.2022;" Duxertibi x-mulegar / Fer.-An. 8806407337 SPOST TUS IPLUM ";3'526.70;;66'399.86;
29.06.2022;29.06.2022;" Dompotalitatete / Fer.-An. 4363287500 CALET Decelione ET ";;220.89;69'926.56;
29.06.2022;29.06.2022;" Detudidivigunno x-mulegar (Canent Reampagro: 8 / Fer.-An. 5676751414) ";9'734.07;;69'705.67;
29.06.2022;29.06.2022;" Duxertibi x-mulegar / Fer.-An. 1341848054 ACIT ANSIVIMEN E/D ";1'410.40;;79'439.74;
29.06.2022;29.06.2022;" Dompotalitatete / Fer.-An. 7366068207 Ment-Mutusquam Nostantegi ";;1'169.00;80'850.14;
28.06.2022;28.06.2022;" Dompotalitatete / Fer.-An. 2376737382 CALET Decelione ET ";;762.85;79'681.14;
28.06.2022;28.06.2022;" Dompotalitatete / Fer.-An. 7548167465 Maratus Schiuva ET ";;58.00;78'918.29;
28.06.2022;28.06.2022;" Dompotalitatete / Fer.-An. 8077603050 Maratus Schiuva ET ";;45.00;78'860.29;
28.06.2022;28.06.2022;" Dompotalitatete / Fer.-An. 7730227821 Maratus Schiuva ET ";;89.00;78'815.29;
28.06.2022;28.06.2022;" Dompotalitatete / Fer.-An. 5020620055 Maratus Schiuva ET ";;129.00;78'726.29;
28.06.2022;28.06.2022;" Dompotalitatete / Fer.-An. 5303730000 Maratus Schiuva ET ";;25.90;78'597.29;
28.06.2022;28.06.2022;" Dompotalitatete / Fer.-An. 8381117081 Maratus Schiuva ET ";;459.00;78'571.39;
28.06.2022;28.06.2022;" Dompotalitatete / Fer.-An. 1566224200 Maratus Schiuva ET ";;89.00;78'112.39;
28.06.2022;28.06.2022;" Dompotalitatete / Fer.-An. 7402614343 Maratus Schiuva ET ";;35.00;78'023.39;
28.06.2022;28.06.2022;" Dompotalitatete / Fer.-An. 4662165401 Maratus Schiuva ET ";;89.00;77'988.39;
28.06.2022;28.06.2022;" Dompotalitatete / Fer.-An. 6881075775 Maratus Schiuva ET ";;89.00;77'899.39;
28.06.2022;28.06.2022;" Dompotalitatete / Fer.-An. 7731681431 Maratus Schiuva ET ";;209.00;77'810.39;
28.06.2022;28.06.2022;" Dompotalitatete / Fer.-An. 2601878538 Maratus Schiuva ET ";;29.90;77'601.39;
28.06.2022;28.06.2022;" Dompotalitatete / Fer.-An. 4205885276 Maratus Schiuva ET ";;129.00;77'571.49;
28.06.2022;28.06.2022;" Dompotalitatete / Fer.-An. 8638384471 Maratus Schiuva ET ";;189.00;77'442.49;
28.06.2022;28.06.2022;" Dompotalitatete / Fer.-An. 2165508342 Maratus Schiuva ET ";;129.00;77'253.49;
28.06.2022;28.06.2022;" Dompotalitatete / Fer.-An. 7285483850 CALET Decelione ET ";;368.15;77'124.49;
28.06.2022;28.06.2022;" Detudidivigunno x-mulegar (Canent Reampagro: 4 / Fer.-An. 8271456538) ";1'615.80;;76'756.34;
28.06.2022;28.06.2022;" Duxertibi x-mulegar / Fer.-An. 5354786270 QUILLE XXX ";2'202.45;;78'372.14;
28.06.2022;26.06.2022;Espoturres xxx Cuproxitalevarae VI DE Perrestem;122.60;;80'574.59;
28.06.2022;28.06.2022;" Dompotalitatete / Fer.-An. 8602670501 PUENTABIT ALITTIS ET ";;3'073.81;80'697.19;
28.06.2022;28.06.2022;" Dompotalitatete / Fer.-An. 6030452705 PUENTABIT ALITTIS ET ";;1'213.60;77'623.38;
28.06.2022;28.06.2022;" Dompotalitatete / Fer.-An. 6053626437 CONCULARTUMN OS ";;541.61;76'409.78;
27.06.2022;27.06.2022;" Dompotalitatete / Fer.-An. 5602858365 Maratus Schiuva ET ";;189.00;75'868.17;
27.06.2022;27.06.2022;" Dompotalitatete / Fer.-An. 1421412577 Maratus Schiuva ET ";;129.00;75'679.17;
27.06.2022;27.06.2022;" Dompotalitatete / Fer.-An. 2856262266 Maratus Schiuva ET ";;609.00;75'550.17;
27.06.2022;27.06.2022;" Dompotalitatete / Fer.-An. 3833767150 Maratus Schiuva ET ";;699.01;74'941.17;
27.06.2022;27.06.2022;" Dompotalitatete / Fer.-An. 8717672034 Maratus Schiuva ET ";;89.00;74'242.16;
27.06.2022;27.06.2022;" Dompotalitatete / Fer.-An. 3844342247 Maratus Schiuva ET ";;129.00;74'153.16;
27.06.2022;27.06.2022;" Dompotalitatete / Fer.-An. 7518443482 Maratus Schiuva ET ";;249.00;74'024.16;
27.06.2022;27.06.2022;" Dompotalitatete / Fer.-An. 3764613232 Maratus Schiuva ET ";;79.00;73'775.16;
27.06.2022;27.06.2022;" Dompotalitatete / Fer.-An. 3454066114 Maratus Schiuva ET ";;479.00;73'696.16;
27.06.2022;27.06.2022;" Dompotalitatete / Fer.-An. 6088580763 Maratus Schiuva ET ";;129.00;73'217.16;
27.06.2022;27.06.2022;" Dompotalitatete / Fer.-An. 1427308366 Maratus Schiuva ET ";;129.00;73'088.16;
27.06.2022;27.06.2022;" Dompotalitatete / Fer.-An. 6674125822 Maratus Schiuva ET ";;479.00;72'959.16;
27.06.2022;27.06.2022;" Dompotalitatete / Fer.-An. 2417253420 Maratus Schiuva ET ";;89.00;72'480.16;
27.06.2022;27.06.2022;" Dompotalitatete / Fer.-An. 1623645386 Maratus Schiuva ET ";;1'309.00;72'391.16;
27.06.2022;27.06.2022;" Dompotalitatete / Fer.-An. 5435574406 Maratus Schiuva ET ";;1'178.00;71'082.16;
27.06.2022;27.06.2022;" Detudidivigunno x-mulegar (Canent Reampagro: 8 / Fer.-An. 7630360112) ";5'237.50;;69'904.16;
27.06.2022;27.06.2022;" Detudidivigunno x-mulegar (Canent Reampagro: 8 / Fer.-An. 3525385016) ";3'445.81;;75'141.66;
27.06.2022;27.06.2022;" Dompotalitatete / Fer.-An. 4452571208 Pint Mintirate ";;998.00;78'587.47;
27.06.2022;27.06.2022;" Dompotalitatete / Fer.-An. 6571835477 Pram Tudicect Tervel ";;856.00;77'589.47;
27.06.2022;27.06.2022;" Dompotalitatete / Fer.-An. 4002478343 Acciliunt RECT SupA ";;29.11;76'733.47;
27.06.2022;27.06.2022;" Dompotalitatete / Fer.-An. 5372280603 PUENTABIT ALITTIS ET ";;3'599.83;76'704.36;
27.06.2022;27.06.2022;" Dompotalitatete / Fer.-An. 3276005875 PUENTABIT ALITTIS ET ";;187.48;73'104.53;
27.06.2022;27.06.2022;" Dompotalitatete / Fer.-An. 5706107285 Volo Insiduci ";;1'000.00;72'917.05;
27.06.2022;25.06.2022;Obsemple-Possubilia 35556442 - DEM Visu;;4'600.00;71'917.05;
24.06.2022;24.06.2022;Ascerantis Cogit 618 65:35;3'000.00;;67'317.05;
24.06.2022;24.06.2022;" Dompotalitatete / Fer.-An. 8183763760 Maratus Schiuva ET ";;89.00;70'317.05;
24.06.2022;24.06.2022;" Dompotalitatete / Fer.-An. 7441355035 Maratus Schiuva ET ";;129.00;70'228.05;
24.06.2022;24.06.2022;" Dompotalitatete / Fer.-An. 6432151270 Maratus Schiuva ET ";;129.00;70'099.05;
24.06.2022;24.06.2022;" Dompotalitatete / Fer.-An. 2466272138 Maratus Schiuva ET ";;89.00;69'970.05;
24.06.2022;24.06.2022;" Dompotalitatete / Fer.-An. 1032708737 Maratus Schiuva ET ";;89.00;69'881.05;
24.06.2022;24.06.2022;" Dompotalitatete / Fer.-An. 5053576163 Maratus Schiuva ET ";;79.00;69'792.05;
24.06.2022;24.06.2022;" Dompotalitatete / Fer.-An. 1308565355 Maratus Schiuva ET ";;210.00;69'713.05;
24.06.2022;24.06.2022;" Dompotalitatete / Fer.-An. 4834318634 Maratus Schiuva ET ";;89.00;69'503.05;
24.06.2022;24.06.2022;" Dompotalitatete / Fer.-An. 2520716405 Maratus Schiuva ET ";;99.00;69'414.05;
24.06.2022;24.06.2022;" Dompotalitatete / Fer.-An. 2642465518 ColeRcitumn ET ";;152.00;69'315.05;
24.06.2022;24.06.2022;" Detudidivigunno x-mulegar (Canent Reampagro: 55 / Fer.-An. 2142884587) ";7'385.05;;69'163.05;
24.06.2022;24.06.2022;" Dompotalitatete / Fer.-An. 8662154183 PUENTABIT ALITTIS ET ";;210.10;76'548.10;
23.06.2022;23.06.2022;" Dompotalitatete / Fer.-An. 3366065167 Corsus Quilor ";;84.90;76'338.00;
23.06.2022;23.06.2022;" Dompotalitatete / Fer.-An. 5078884037 CALET Decelione ET ";;2'097.37;76'253.10;
23.06.2022;22.06.2022;Espoturres xxx Cuproxitalevarae SI Suctus Micto Olum;56.00;;74'155.73;
23.06.2022;23.06.2022;" Detudidivigunno x-mulegar (Canent Reampagro: 8 / Fer.-An. 5046817650) ";3'211.35;;74'211.73;
23.06.2022;23.06.2022;" Dompotalitatete / Fer.-An. 8888401104 PUENTABIT ALITTIS ET ";;476.70;77'423.08;
23.06.2022;23.06.2022;" Duxertibi x-mulegar / Fer.-An. 4060837541 ITULATURO PLUMN ";706.71;;76'946.38;
23.06.2022;23.06.2022;" Dompotalitatete / Fer.-An. 2108288380 Nungun Ocutum ";;517.00;77'653.09;
22.06.2022;22.06.2022;" Dompotalitatete / Fer.-An. 1260237764 CALET Decelione ET ";;171.74;77'136.09;
22.06.2022;22.06.2022;" Dompotalitatete / Fer.-An. 1340015344 PUENTABIT ALITTIS ET ";;1'399.80;76'964.35;
22.06.2022;22.06.2022;" Detudidivigunno x-mulegar (Canent Reampagro: 8 / Fer.-An. 6221513540) ";2'051.67;;75'564.55;
22.06.2022;22.06.2022;" Duxertibi x-mulegar / Fer.-An. 8812400383 AQUADA + DERUM ET ";373.30;;77'616.22;
21.06.2022;21.06.2022;Obsemple-Possubilia 46877467 - DEM Henti, 42A-Orba;;82.10;77'989.52;
21.06.2022;21.06.2022;Obsemple-Possubilia 46877467 - DEM Henti, 42A-Orba;;1'890.00;77'907.42;
21.06.2022;21.06.2022;" Duxertibi x-mulegar / Fer.-An. 3870640555 ACIT ANSIVIMEN E/D ";357.94;;76'017.42;
21.06.2022;21.06.2022;" Dompotalitatete / Fer.-An. 8616062436 CALET Decelione ET ";;2'444.60;76'375.36;
21.06.2022;21.06.2022;" Dompotalitatete / Fer.-An. 8444070177 Maratus Schiuva ET ";;96.00;73'930.76;
21.06.2022;21.06.2022;" Dompotalitatete / Fer.-An. 5313275635 Maratus Schiuva ET ";;29.90;73'834.76;
21.06.2022;21.06.2022;" Dompotalitatete / Fer.-An. 3815412433 Maratus Schiuva ET ";;89.00;73'804.86;
21.06.2022;21.06.2022;" Dompotalitatete / Fer.-An. 1747146615 Maratus Schiuva ET ";;239.00;73'715.86;
21.06.2022;21.06.2022;" Dompotalitatete / Fer.-An. 6200063785 Maratus Schiuva ET ";;129.00;73'476.86;
21.06.2022;21.06.2022;" Dompotalitatete / Fer.-An. 8686505311 Maratus Schiuva ET ";;129.00;73'347.86;
21.06.2022;21.06.2022;" Dompotalitatete / Fer.-An. 3722542371 Maratus Schiuva ET ";;89.00;73'218.86;
21.06.2022;21.06.2022;" Dompotalitatete / Fer.-An. 5565742528 Maratus Schiuva ET ";;89.00;73'129.86;
21.06.2022;21.06.2022;" Dompotalitatete / Fer.-An. 7310546050 Maratus Schiuva ET ";;89.00;73'040.86;
21.06.2022;21.06.2022;" Dompotalitatete / Fer.-An. 1178540468 Maratus Schiuva ET ";;69.00;72'951.86;
21.06.2022;21.06.2022;" Dompotalitatete / Fer.-An. 4436151051 Maratus Schiuva ET ";;119.00;72'882.86;
21.06.2022;21.06.2022;" Dompotalitatete / Fer.-An. 3482004524 Maratus Schiuva ET ";;189.00;72'763.86;
21.06.2022;21.06.2022;" Dompotalitatete / Fer.-An. 2386643001 Maratus Schiuva ET ";;89.00;72'574.86;
21.06.2022;21.06.2022;" Dompotalitatete / Fer.-An. 7411074724 Maratus Schiuva ET ";;59.00;72'485.86;
21.06.2022;21.06.2022;" Dompotalitatete / Fer.-An. 1481103287 Maratus Schiuva ET ";;59.00;72'426.86;
21.06.2022;21.06.2022;" Dompotalitatete / Fer.-An. 4276741628 Maratus Schiuva ET ";;359.00;72'367.86;
21.06.2022;21.06.2022;" Dompotalitatete / Fer.-An. 7125388183 Maratus Schiuva ET ";;1'069.00;72'008.86;
21.06.2022;21.06.2022;" Dompotalitatete / Fer.-An. 7183652763 Maratus Schiuva ET ";;89.00;70'939.86;
21.06.2022;21.06.2022;" Dompotalitatete / Fer.-An. 2064181072 Maratus Schiuva ET ";;129.00;70'850.86;
21.06.2022;21.06.2022;" Dompotalitatete / Fer.-An. 2578552781 Maratus Schiuva ET ";;89.00;70'721.86;
21.06.2022;21.06.2022;" Dompotalitatete / Fer.-An. 7471263333 Maratus Schiuva ET ";;59.00;70'632.86;
21.06.2022;21.06.2022;" Dompotalitatete / Fer.-An. 8316757431 Maratus Schiuva ET ";;70.00;70'573.86;
21.06.2022;21.06.2022;" Dompotalitatete / Fer.-An. 4578784346 Maratus Schiuva ET ";;129.00;70'503.86;
21.06.2022;21.06.2022;" Dompotalitatete / Fer.-An. 7251535747 Maratus Schiuva ET ";;132.00;70'374.86;
21.06.2022;21.06.2022;" Dompotalitatete / Fer.-An. 5887234724 Maratus Schiuva ET ";;35.00;70'242.86;
21.06.2022;21.06.2022;" Dompotalitatete / Fer.-An. 2650234806 CUNCTO TEM TAM ";;1'415.09;70'207.86;
21.06.2022;21.06.2022;" Dompotalitatete / Fer.-An. 7770250436 CONCULARTUMN OS ";;4'229.11;68'792.77;
21.06.2022;21.06.2022;" Dompotalitatete / Fer.-An. 8704351702 CALET Decelione ET ";;1'462.74;64'563.66;
21.06.2022;17.06.2022;Espoturres xxx Cuproxitalevarae plum.vi Fraest BY;240.50;;63'100.92;
21.06.2022;21.06.2022;" Dompotalitatete / Fer.-An. 1507856750 PUENTABIT ALITTIS ET ";;3'205.50;63'341.42;
21.06.2022;21.06.2022;" Detudidivigunno x-mulegar (Canent Reampagro: 4 / Fer.-An. 5400311387) ";4'482.48;;60'135.92;
21.06.2022;21.06.2022;" Dompotalitatete / Fer.-An. 4374612231 PUENTABIT ALITTIS ET ";;1'321.10;64'618.40;
21.06.2022;21.06.2022;" Dompotalitatete / Fer.-An. 6881068404 PUENTABIT ALITTIS ET ";;3'271.28;63'297.30;
20.06.2022;20.06.2022;Obsemple-Possubilia 17515211 - DEM Cogit, Orervo, XXX;;7'400.00;60'026.02;
20.06.2022;20.06.2022;" Duxertibi x-mulegar / Fer.-An. 6373452810 ACIT ANSIVIMEN E/D ";838.08;;52'626.02;
20.06.2022;20.06.2022;" Dompotalitatete / Fer.-An. 2525760646 Maratus Schiuva ET ";;89.00;53'464.10;
20.06.2022;20.06.2022;" Dompotalitatete / Fer.-An. 1311750287 Maratus Schiuva ET ";;35.00;53'375.10;
20.06.2022;20.06.2022;" Dompotalitatete / Fer.-An. 2681571738 Maratus Schiuva ET ";;1'350.00;53'340.10;
20.06.2022;20.06.2022;" Detudidivigunno x-mulegar (Canent Reampagro: 6 / Fer.-An. 2811557887) ";8'139.63;;51'990.10;
20.06.2022;20.06.2022;" Duxertibi x-mulegar / Fer.-An. 4685682534 TANDUS SPUTE PLEGILE SUPA ";767.57;;60'129.73;
20.06.2022;20.06.2022;" Dompotalitatete / Fer.-An. 3501215175 PUENTABIT ALITTIS ET ";;2'316.59;60'897.30;
20.06.2022;20.06.2022;" Dompotalitatete / Fer.-An. 5171756372 PUENTABIT ALITTIS ET ";;1'218.28;58'580.71;
20.06.2022;18.06.2022;Espoturres xxx Cuproxitalevarae Scidedens-Brevelia O;5.00;;57'362.43;
20.06.2022;18.06.2022;Obsemple-Possubilia 35556442 - DEM Visu;;2'600.00;57'367.43;
20.06.2022;16.06.2022;Espoturres xxx Cuproxitalevarae REQUAE *QKN0714840444 200-368-7228;1'000.00;;54'767.43;
20.06.2022;17.06.2022;Espoturres xxx Cuproxitalevarae Iöost Senitto ET;79.60;;55'767.43;
20.06.2022;17.06.2022;Obsemple-Possubilia 35556442 - DEM Visu;;1'890.00;55'847.03;
17.06.2022;17.06.2022;" Dompotalitatete / Fer.-An. 1467842785 Maratus Schiuva ET ";;89.00;53'957.03;
17.06.2022;17.06.2022;" Dompotalitatete / Fer.-An. 2515260574 Maratus Schiuva ET ";;35.00;53'868.03;
17.06.2022;17.06.2022;" Dompotalitatete / Fer.-An. 1315286748 Maratus Schiuva ET ";;859.00;53'833.03;
17.06.2022;17.06.2022;" Dompotalitatete / Fer.-An. 7446133104 Maratus Schiuva ET ";;259.00;52'974.03;
17.06.2022;17.06.2022;" Dompotalitatete / Fer.-An. 5278666030 Maratus Schiuva ET ";;189.00;52'715.03;
17.06.2022;17.06.2022;" Dompotalitatete / Fer.-An. 4318522170 Maratus Schiuva ET ";;129.00;52'526.03;
17.06.2022;17.06.2022;" Dompotalitatete / Fer.-An. 2784047502 Maratus Schiuva ET ";;109.00;52'397.03;
17.06.2022;17.06.2022;" Dompotalitatete / Fer.-An. 7675580640 Maratus Schiuva ET ";;129.00;52'288.03;
17.06.2022;17.06.2022;" Dompotalitatete / Fer.-An. 8835835046 Maratus Schiuva ET ";;129.00;52'159.03;
17.06.2022;17.06.2022;" Dompotalitatete / Fer.-An. 7878726258 Maratus Schiuva ET ";;129.00;52'030.03;
17.06.2022;17.06.2022;" Dompotalitatete / Fer.-An. 4265810268 Maratus Schiuva ET ";;949.00;51'901.03;
17.06.2022;17.06.2022;" Dompotalitatete / Fer.-An. 7754555574 Maratus Schiuva ET ";;559.00;50'952.03;
17.06.2022;17.06.2022;" Dompotalitatete / Fer.-An. 3445105421 Maratus Schiuva ET ";;719.01;50'393.03;
17.06.2022;17.06.2022;" Dompotalitatete / Fer.-An. 2220068187 Maratus Schiuva ET ";;35.00;49'674.02;
17.06.2022;17.06.2022;" Dompotalitatete / Fer.-An. 8311858714 Maratus Schiuva ET ";;79.00;49'639.02;
17.06.2022;17.06.2022;" Dompotalitatete / Fer.-An. 8242617748 Maratus Schiuva ET ";;129.00;49'560.02;
17.06.2022;17.06.2022;" Dompotalitatete / Fer.-An. 6151878367 Maratus Schiuva ET ";;29.90;49'431.02;
17.06.2022;17.06.2022;" Dompotalitatete / Fer.-An. 7448654712 ColeRcitumn ET ";;349.44;49'401.12;
17.06.2022;17.06.2022;" Dompotalitatete / Fer.-An. 6406638704 PUENTABIT ALITTIS ET ";;916.20;49'051.68;
17.06.2022;17.06.2022;" Duxertibi x-mulegar / Fer.-An. 7673001422 ACIT ANSIVIMEN E/D ";4'676.39;;48'135.48;
16.06.2022;16.06.2022;" Duxertibi x-mulegar / Fer.-An. 6783224840 REQUAE MITUUNT LODIVIT ";2'000.00;;52'811.87;
16.06.2022;15.06.2022;Espoturres xxx Cuproxitalevarae Murrem ET Hetuensit;288.10;;54'811.87;
16.06.2022;16.06.2022;" Duxertibi x-mulegar / Fer.-An. 3882747033 I. PERINI PETIA E/D ";2'643.91;;55'099.97;
16.06.2022;16.06.2022;" Dompotalitatete / Fer.-An. 1578417587 Acciliunt RECT SupA ";;97.05;57'743.88;
16.06.2022;16.06.2022;" Dompotalitatete / Fer.-An. 5061511501 Etura Prodecutis ";;568.00;57'646.83;
15.06.2022;15.06.2022;" Dompotalitatete / Fer.-An. 5773420274 Maratus Schiuva ET ";;29.90;57'078.83;
15.06.2022;15.06.2022;" Dompotalitatete / Fer.-An. 5725666284 Maratus Schiuva ET ";;64.90;57'048.93;
15.06.2022;15.06.2022;" Dompotalitatete / Fer.-An. 6072452808 Maratus Schiuva ET ";;129.00;56'984.03;
15.06.2022;15.06.2022;" Dompotalitatete / Fer.-An. 4138431781 Maratus Schiuva ET ";;199.00;56'855.03;
15.06.2022;15.06.2022;" Dompotalitatete / Fer.-An. 3277138675 Maratus Schiuva ET ";;119.00;56'656.03;
15.06.2022;15.06.2022;" Dompotalitatete / Fer.-An. 3065352675 Maratus Schiuva ET ";;149.00;56'537.03;
15.06.2022;15.06.2022;" Dompotalitatete / Fer.-An. 1823448514 Maratus Schiuva ET ";;98.00;56'388.03;
15.06.2022;15.06.2022;" Dompotalitatete / Fer.-An. 2048834604 Maratus Schiuva ET ";;179.00;56'290.03;
15.06.2022;15.06.2022;" Dompotalitatete / Fer.-An. 7450065660 Maratus Schiuva ET ";;89.00;56'111.03;
15.06.2022;15.06.2022;" Dompotalitatete / Fer.-An. 3123828875 Maratus Schiuva ET ";;89.00;56'022.03;
15.06.2022;15.06.2022;" Dompotalitatete / Fer.-An. 1421421342 Maratus Schiuva ET ";;369.00;55'933.03;
15.06.2022;15.06.2022;" Dompotalitatete / Fer.-An. 7110035047 Maratus Schiuva ET ";;69.00;55'564.03;
15.06.2022;15.06.2022;" Dompotalitatete / Fer.-An. 3012822251 Maratus Schiuva ET ";;79.00;55'495.03;
15.06.2022;15.06.2022;" Dompotalitatete / Fer.-An. 8404760214 Maratus Schiuva ET ";;89.00;55'416.03;
15.06.2022;15.06.2022;" Dompotalitatete / Fer.-An. 5475573702 Maratus Schiuva ET ";;48.00;55'327.03;
15.06.2022;15.06.2022;" Dompotalitatete / Fer.-An. 1338235804 Maratus Schiuva ET ";;109.00;55'279.03;
15.06.2022;15.06.2022;" Dompotalitatete / Fer.-An. 8368026466 Maratus Schiuva ET ";;189.00;55'170.03;
15.06.2022;15.06.2022;" Dompotalitatete / Fer.-An. 6524742246 Maratus Schiuva ET ";;89.00;54'981.03;
15.06.2022;15.06.2022;" Dompotalitatete / Fer.-An. 1445662855 Maratus Schiuva ET ";;559.00;54'892.03;
15.06.2022;15.06.2022;" Dompotalitatete / Fer.-An. 2378580711 Maratus Schiuva ET ";;729.00;54'333.03;
15.06.2022;15.06.2022;" Dompotalitatete / Fer.-An. 3855173701 Maratus Schiuva ET ";;1'317.98;53'604.03;
15.06.2022;15.06.2022;" Dompotalitatete / Fer.-An. 2268044836 Maratus Schiuva ET ";;919.00;52'286.05;
15.06.2022;15.06.2022;" Dompotalitatete / Fer.-An. 7843556865 ColeRcitumn ET ";;1'289.77;51'367.05;
15.06.2022;15.06.2022;" Dompotalitatete / Fer.-An. 2838840455 CALET Decelione ET ";;211.22;50'077.28;
15.06.2022;15.06.2022;" Detudidivigunno x-mulegar (Canent Reampagro: 8 / Fer.-An. 2124157570) ";1'492.65;;49'866.06;
15.06.2022;15.06.2022;" Dompotalitatete / Fer.-An. 4414644270 Acciliunt RECT SupA ";;176.34;51'358.71;
14.06.2022;14.06.2022;" Dompotalitatete / Fer.-An. 7263053250 CALET Decelione ET ";;1'205.03;51'182.37;
14.06.2022;14.06.2022;" Duxertibi x-mulegar / Fer.-An. 7363186631 INTEST CAPH ";225.00;;49'977.34;
14.06.2022;14.06.2022;" Dompotalitatete / Fer.-An. 4532206287 Maratus Schiuva ET ";;79.00;50'202.34;
14.06.2022;14.06.2022;" Dompotalitatete / Fer.-An. 7735171000 Maratus Schiuva ET ";;129.00;50'123.34;
14.06.2022;14.06.2022;" Dompotalitatete / Fer.-An. 6027152476 Maratus Schiuva ET ";;129.00;49'994.34;
14.06.2022;14.06.2022;" Duxertibi x-mulegar / Fer.-An. 5117083336 SPOST TUS IPLUM ";2'000.00;;49'865.34;
14.06.2022;14.06.2022;" Dompotalitatete / Fer.-An. 1368658452 CALET Decelione ET ";;1'852.50;51'865.34;
14.06.2022;12.06.2022;Espoturres xxx Cuproxitalevarae REQUAE *QKN0714840444 200-368-7228;1'000.00;;50'012.84;
14.06.2022;14.06.2022;" Dompotalitatete / Fer.-An. 1456120718 CALET Decelione ET ";;230.76;51'012.84;
14.06.2022;14.06.2022;" Dompotalitatete / Fer.-An. 4172185653 PUENTABIT ALITTIS ET ";;1'141.33;50'782.08;
14.06.2022;14.06.2022;" Dompotalitatete / Fer.-An. 3272564351 PUENTABIT ALITTIS ET ";;2'914.50;49'640.75;
14.06.2022;14.06.2022;" Dompotalitatete / Fer.-An. 5841116722 PUENTABIT ALITTIS ET ";;2'736.61;46'726.25;
14.06.2022;14.06.2022;" Duxertibi x-mulegar / Fer.-An. 2466655482 VOLLUM FORBICULA ";9'965.00;;43'989.64;
14.06.2022;14.06.2022;" Dompotalitatete / Fer.-An. 7288546730 Acciliunt RECT SupA ";;1'157.81;53'954.64;
14.06.2022;14.06.2022;" Dompotalitatete / Fer.-An. 4767647000 CONCULARTUMN OS ";;8'924.25;52'796.83;
13.06.2022;13.06.2022;" Dompotalitatete / Fer.-An. 2006870485 Maratus Schiuva ET ";;89.00;43'872.58;
13.06.2022;13.06.2022;" Dompotalitatete / Fer.-An. 4132436381 Maratus Schiuva ET ";;409.00;43'783.58;
13.06.2022;13.06.2022;" Dompotalitatete / Fer.-An. 4034546333 Maratus Schiuva ET ";;89.00;43'374.58;
13.06.2022;13.06.2022;" Dompotalitatete / Fer.-An. 4612680541 Maratus Schiuva ET ";;89.00;43'285.58;
13.06.2022;13.06.2022;" Dompotalitatete / Fer.-An. 7682234772 Maratus Schiuva ET ";;89.00;43'196.58;
13.06.2022;13.06.2022;" Dompotalitatete / Fer.-An. 5816821466 Maratus Schiuva ET ";;289.00;43'107.58;
13.06.2022;13.06.2022;" Dompotalitatete / Fer.-An. 1110352454 Maratus Schiuva ET ";;89.00;42'818.58;
13.06.2022;13.06.2022;" Dompotalitatete / Fer.-An. 6017075153 Maratus Schiuva ET ";;129.00;42'729.58;
13.06.2022;13.06.2022;" Dompotalitatete / Fer.-An. 2544362667 Maratus Schiuva ET ";;79.00;42'600.58;
13.06.2022;13.06.2022;" Dompotalitatete / Fer.-An. 6433434663 Maratus Schiuva ET ";;149.00;42'521.58;
13.06.2022;13.06.2022;" Dompotalitatete / Fer.-An. 7455443013 Maratus Schiuva ET ";;89.00;42'372.58;
13.06.2022;13.06.2022;" Dompotalitatete / Fer.-An. 2346507881 Maratus Schiuva ET ";;149.00;42'283.58;
13.06.2022;13.06.2022;" Dompotalitatete / Fer.-An. 4150682444 Maratus Schiuva ET ";;89.00;42'134.58;
13.06.2022;13.06.2022;" Dompotalitatete / Fer.-An. 7187088116 CALET Decelione ET ";;1'021.54;42'045.58;
13.06.2022;13.06.2022;" Duxertibi x-mulegar / Fer.-An. 3764528441 FLUMENT DICA ET ";4'150.00;;41'024.04;
13.06.2022;13.06.2022;" Dompotalitatete / Fer.-An. 1818211274 PUENTABIT ALITTIS ET ";;655.25;45'174.04;
13.06.2022;13.06.2022;" Dompotalitatete / Fer.-An. 1341644320 PUENTABIT ALITTIS ET ";;422.05;44'518.79;
13.06.2022;13.06.2022;" Duxertibi x-mulegar / Fer.-An. 4224246804 HOC ALITTIS ET ";2'961.90;;44'096.74;
13.06.2022;10.06.2022;Espoturres xxx Cuproxitalevarae Spete Carae;116.64;;47'058.64;
13.06.2022;09.06.2022;Espoturres xxx Cuproxitalevarae SENTI NUISIMIUNE ANS;21.39;;47'175.28;
13.06.2022;09.06.2022;Espoturres xxx Cuproxitalevarae CONGE NOTAS. CUPLII;5.96;;47'196.67;
13.06.2022;09.06.2022;Espoturres xxx Cuproxitalevarae FERRE NOTAS.DITUUNT;4.28;;47'202.63;
13.06.2022;09.06.2022;Espoturres xxx Cuproxitalevarae FERRE NOTAS.DITUUNT;4.91;;47'206.91;
13.06.2022;09.06.2022;Espoturres xxx Cuproxitalevarae FERRE NOTAS. CUPLII;4.92;;47'211.82;
13.06.2022;09.06.2022;Espoturres xxx Cuproxitalevarae REAMUNTIOLOR;16.56;;47'216.74;
13.06.2022;09.06.2022;Espoturres xxx Cuproxitalevarae D&I DION MORIDES' O;81.20;;47'233.30;
13.06.2022;09.06.2022;Espoturres xxx Cuproxitalevarae REAMUNTIOLOR;42.69;;47'314.50;
10.06.2022;09.06.2022;Frateride UT J0 Plar adige;164.37;;47'357.19;
10.06.2022;10.06.2022;" Dompotalitatete / Fer.-An. 3537543122 CALET Decelione ET ";;117.16;47'521.56;
10.06.2022;08.06.2022;Espoturres xxx Cuproxitalevarae REQUAE *QKN0714840444 200-368-7228;1'000.00;;47'404.40;
10.06.2022;10.06.2022;" Detudidivigunno x-mulegar (Canent Reampagro: 8 / Fer.-An. 7673814706) ";9'985.65;;48'404.40;
10.06.2022;09.06.2022;Espoturres xxx Cuproxitalevarae RACUS Osimeris J0;26.80;;58'390.05;
10.06.2022;09.06.2022;Espoturres xxx Cuproxitalevarae RACUS Osimeris J0;115.05;;58'416.85;
10.06.2022;10.06.2022;" Dompotalitatete / Fer.-An. 1188758230 PUENTABIT ALITTIS ET ";;959.32;58'531.90;
09.06.2022;09.06.2022;" Dompotalitatete / Fer.-An. 6706233806 Maratus Schiuva ET ";;89.00;57'572.58;
09.06.2022;09.06.2022;" Dompotalitatete / Fer.-An. 3551836262 Maratus Schiuva ET ";;199.00;57'483.58;
09.06.2022;09.06.2022;" Dompotalitatete / Fer.-An. 3017107661 Maratus Schiuva ET ";;189.00;57'284.58;
09.06.2022;09.06.2022;" Dompotalitatete / Fer.-An. 2700541045 Maratus Schiuva ET ";;79.00;57'095.58;
09.06.2022;09.06.2022;" Dompotalitatete / Fer.-An. 6780075120 Maratus Schiuva ET ";;129.00;57'016.58;
09.06.2022;09.06.2022;" Dompotalitatete / Fer.-An. 3144657361 Maratus Schiuva ET ";;249.00;56'887.58;
09.06.2022;09.06.2022;" Dompotalitatete / Fer.-An. 5748870585 Maratus Schiuva ET ";;378.00;56'638.58;
09.06.2022;09.06.2022;" Dompotalitatete / Fer.-An. 2123162217 Maratus Schiuva ET ";;89.00;56'260.58;
09.06.2022;09.06.2022;" Dompotalitatete / Fer.-An. 4734210188 Maratus Schiuva ET ";;249.00;56'171.58;
09.06.2022;09.06.2022;" Dompotalitatete / Fer.-An. 8141160725 Maratus Schiuva ET ";;189.00;55'922.58;
09.06.2022;09.06.2022;" Dompotalitatete / Fer.-An. 1203078104 Maratus Schiuva ET ";;89.00;55'733.58;
09.06.2022;09.06.2022;" Dompotalitatete / Fer.-An. 7188403573 Maratus Schiuva ET ";;119.00;55'644.58;
09.06.2022;09.06.2022;" Dompotalitatete / Fer.-An. 2766255340 CUNCTO TEM TAM ";;2'601.70;55'525.58;
09.06.2022;09.06.2022;" Duxertibi x-mulegar / Fer.-An. 7281477057 MODIE SPUER ";79.00;;52'923.88;
09.06.2022;09.06.2022;" Dompotalitatete / Fer.-An. 1015748888 CALET Decelione ET ";;591.21;53'002.88;
09.06.2022;08.06.2022;Espoturres xxx Cuproxitalevarae Intrisurriava-1640 O;549.80;;52'411.67;
09.06.2022;09.06.2022;" Dompotalitatete / Fer.-An. 5276167588 Minabyssit Carget SupA ";;500.00;52'961.47;
09.06.2022;09.06.2022;" Duxertibi x-mulegar / Fer.-An. 6882267574 I. PERINI PETIA E/D ";2'666.84;;52'461.47;
08.06.2022;08.06.2022;" Dompotalitatete / Fer.-An. 1452152286 CALET Decelione ET ";;921.86;55'128.31;
08.06.2022;08.06.2022;" Dompotalitatete / Fer.-An. 1206310864 AUDUCTIA MORTAE K/N ";;3'750.00;54'206.45;
08.06.2022;08.06.2022;" Dompotalitatete / Fer.-An. 8618403007 Maratus Schiuva ET ";;275.00;50'456.45;
08.06.2022;08.06.2022;" Dompotalitatete / Fer.-An. 2342447155 Maratus Schiuva ET ";;309.00;50'181.45;
08.06.2022;08.06.2022;" Dompotalitatete / Fer.-An. 7117521271 Maratus Schiuva ET ";;34.89;49'872.45;
08.06.2022;08.06.2022;" Dompotalitatete / Fer.-An. 1088760155 Maratus Schiuva ET ";;22.90;49'837.56;
08.06.2022;08.06.2022;" Dompotalitatete / Fer.-An. 1683130888 Maratus Schiuva ET ";;129.00;49'814.66;
08.06.2022;08.06.2022;" Dompotalitatete / Fer.-An. 4307765666 Maratus Schiuva ET ";;109.00;49'685.66;
08.06.2022;08.06.2022;" Dompotalitatete / Fer.-An. 1622660820 Maratus Schiuva ET ";;74.00;49'576.66;
08.06.2022;08.06.2022;" Dompotalitatete / Fer.-An. 5576822543 Maratus Schiuva ET ";;22.90;49'502.66;
08.06.2022;08.06.2022;" Dompotalitatete / Fer.-An. 8651674448 Maratus Schiuva ET ";;79.00;49'479.76;
08.06.2022;08.06.2022;" Dompotalitatete / Fer.-An. 2265340458 Maratus Schiuva ET ";;34.89;49'400.76;
08.06.2022;08.06.2022;" Dompotalitatete / Fer.-An. 7811017060 Maratus Schiuva ET ";;109.00;49'365.87;
08.06.2022;08.06.2022;" Dompotalitatete / Fer.-An. 5245763318 Maratus Schiuva ET ";;169.00;49'256.87;
08.06.2022;08.06.2022;" Dompotalitatete / Fer.-An. 8368075153 Maratus Schiuva ET ";;430.00;49'087.87;
08.06.2022;08.06.2022;" Dompotalitatete / Fer.-An. 7626442328 CALET Decelione ET ";;88.73;48'657.87;
08.06.2022;08.06.2022;" Dompotalitatete / Fer.-An. 1550668368 CONCULARTUMN OS ";;1'101.65;48'569.14;
08.06.2022;05.06.2022;Espoturres xxx Cuproxitalevarae REQUAE *QKN0714840444 200-368-7228;1'000.00;;47'467.49;
08.06.2022;08.06.2022;" Dompotalitatete / Fer.-An. 6158564783 CALET Decelione ET ";;1'071.68;48'467.49;
08.06.2022;08.06.2022;" Dompotalitatete / Fer.-An. 6384645752 PUENTABIT ALITTIS ET ";;1'066.23;47'395.81;
08.06.2022;08.06.2022;" Dompotalitatete / Fer.-An. 4784523877 PUENTABIT ALITTIS ET ";;1'174.10;46'329.58;
08.06.2022;08.06.2022;" Dompotalitatete / Fer.-An. 7830241475 PUENTABIT ALITTIS ET ";;8'283.14;45'155.48;
08.06.2022;08.06.2022;" Dompotalitatete / Fer.-An. 2682560185 PUENTABIT ALITTIS ET ";;866.35;36'872.34;
08.06.2022;08.06.2022;" Detudidivigunno x-mulegar (Canent Reampagro: 7 / Fer.-An. 2442663174) ";23'607.60;;36'005.99;
08.06.2022;08.06.2022;" Dompotalitatete / Fer.-An. 5808840881 PUENTABIT ALITTIS ET ";;488.47;59'613.59;
08.06.2022;08.06.2022;" Dompotalitatete / Fer.-An. 4015021287 Ocum Revem Pilianium xxx Prow Stabus Vilitur ";;2'100.00;59'125.12;
08.06.2022;08.06.2022;" Dompotalitatete / Fer.-An. 7612012736 Volo Funix / Ficor Equaer ";;843.00;57'025.12;
07.06.2022;07.06.2022;" Dompotalitatete / Fer.-An. 8344602328 Maratus Schiuva ET ";;249.00;56'182.12;
07.06.2022;07.06.2022;" Dompotalitatete / Fer.-An. 6350543587 Maratus Schiuva ET ";;384.00;55'933.12;
07.06.2022;07.06.2022;" Dompotalitatete / Fer.-An. 8345773674 Maratus Schiuva ET ";;129.00;55'549.12;
07.06.2022;07.06.2022;" Dompotalitatete / Fer.-An. 1402202774 Maratus Schiuva ET ";;369.00;55'420.12;
07.06.2022;07.06.2022;" Dompotalitatete / Fer.-An. 4831212208 Maratus Schiuva ET ";;129.00;55'051.12;
07.06.2022;07.06.2022;" Dompotalitatete / Fer.-An. 8857808735 Maratus Schiuva ET ";;175.00;54'922.12;
07.06.2022;07.06.2022;" Dompotalitatete / Fer.-An. 1104580214 Maratus Schiuva ET ";;210.00;54'747.12;
07.06.2022;07.06.2022;" Dompotalitatete / Fer.-An. 2602515531 Maratus Schiuva ET ";;149.00;54'537.12;
07.06.2022;07.06.2022;" Dompotalitatete / Fer.-An. 8275770076 Maratus Schiuva ET ";;259.00;54'388.12;
07.06.2022;07.06.2022;" Dompotalitatete / Fer.-An. 4713223741 Maratus Schiuva ET ";;818.00;54'129.12;
07.06.2022;07.06.2022;" Dompotalitatete / Fer.-An. 1867614250 Maratus Schiuva ET ";;609.00;53'311.12;
07.06.2022;07.06.2022;" Detudidivigunno x-mulegar (Canent Reampagro: 4 / Fer.-An. 2733387625) ";336.79;;52'702.12;
07.06.2022;07.06.2022;" Detudidivigunno x-mulegar (Canent Reampagro: 4 / Fer.-An. 3028283405) ";5'220.65;;53'038.91;
07.06.2022;07.06.2022;" Dompotalitatete / Fer.-An. 1115646228 Peranium Aquarevalum ";;294.00;58'259.56;
07.06.2022;07.06.2022;" Dompotalitatete / Fer.-An. 3023815875 Ocum Pint Orexactudo ";;1'618.00;57'965.56;
07.06.2022;07.06.2022;" Duxertibi x-mulegar / Fer.-An. 1077043710 PARSULCHORABSEX BIBULIATUBSICULO ";4'113.05;;56'347.56;
07.06.2022;07.06.2022;" Dompotalitatete / Fer.-An. 4650375447 Ocum Ingunix Ilitabiit Debili xxx Prow Subsec Debili ";;74.80;60'460.61;
06.06.2022;05.06.2022;Obsemple-Possubilia 35556442 - DEM Visu;;2'270.00;60'385.81;
03.06.2022;03.06.2022;" Dompotalitatete / Fer.-An. 7882351305 Posta Alor + Ligit Posta Hunt ";;708.00;58'115.81;
03.06.2022;03.06.2022;" Dompotalitatete / Fer.-An. 2412020156 Maratus Schiuva ET ";;25.90;57'407.81;
03.06.2022;03.06.2022;" Dompotalitatete / Fer.-An. 2721364734 Maratus Schiuva ET ";;149.00;57'381.91;
03.06.2022;03.06.2022;" Dompotalitatete / Fer.-An. 8033206343 Maratus Schiuva ET ";;109.00;57'232.91;
03.06.2022;03.06.2022;" Dompotalitatete / Fer.-An. 3716252608 Maratus Schiuva ET ";;69.90;57'123.91;
03.06.2022;03.06.2022;" Dompotalitatete / Fer.-An. 4602085234 Maratus Schiuva ET ";;239.00;57'054.01;
03.06.2022;03.06.2022;" Dompotalitatete / Fer.-An. 8330423544 Maratus Schiuva ET ";;129.00;56'815.01;
03.06.2022;03.06.2022;" Dompotalitatete / Fer.-An. 2220543837 Maratus Schiuva ET ";;239.00;56'686.01;
03.06.2022;03.06.2022;" Dompotalitatete / Fer.-An. 8705777147 ColeRcitumn ET ";;813.54;56'447.01;
03.06.2022;01.06.2022;Espoturres xxx Cuproxitalevarae REQUAE *QKN0714840444 et@requae.hat;1'812.40;;55'633.47;
03.06.2022;03.06.2022;" Detudidivigunno x-mulegar (Canent Reampagro: 8 / Fer.-An. 5525442282) ";8'140.70;;57'445.87;
03.06.2022;03.06.2022;" Dompotalitatete / Fer.-An. 8656827664 PUENTABIT ALITTIS ET ";;131.41;65'586.57;
03.06.2022;03.06.2022;" Dompotalitatete / Fer.-An. 1787426547 Vi Ponstram Divide Umen Merumn rier Cierte Nettini ";;1'224.50;65'455.16;
02.06.2022;02.06.2022;" Dompotalitatete / Fer.-An. 2262138321 Fun E. T. xxx Fun A. ";;500.00;64'230.66;
02.06.2022;02.06.2022;" Duxertibi x-mulegar / Fer.-An. 7788735700 I. PERINI PETIA E/D ";2'609.47;;63'730.66;
02.06.2022;02.06.2022;" Dompotalitatete / Fer.-An. 7087203885 PUENTABIT ALITTIS ET ";;2'771.79;66'340.13;
02.06.2022;02.06.2022;" Duxertibi x-mulegar / Fer.-An. 2217824533 ";545.90;;63'568.34;
02.06.2022;02.06.2022;" Duxertibi x-mulegar / Fer.-An. 8266354738 PANTHO PRATU ";1'823.45;;64'114.24;
02.06.2022;02.06.2022;" Dompotalitatete / Fer.-An. 5656861220 Bone Placus xxx Brell Dite Placus ";;2'250.00;65'937.69;
01.06.2022;01.06.2022;" Dompotalitatete / Fer.-An. 7226846146 Fun E. T. xxx Fun A. ";;500.00;63'687.69;
01.06.2022;01.06.2022;" Dompotalitatete / Fer.-An. 4301018652 Maratus Schiuva ET ";;119.00;63'187.69;
01.06.2022;01.06.2022;" Dompotalitatete / Fer.-An. 4284312587 Maratus Schiuva ET ";;109.00;63'068.69;
01.06.2022;01.06.2022;" Dompotalitatete / Fer.-An. 4657713321 Maratus Schiuva ET ";;119.00;62'959.69;
01.06.2022;01.06.2022;" Dompotalitatete / Fer.-An. 3637286242 Maratus Schiuva ET ";;129.00;62'840.69;
01.06.2022;01.06.2022;" Dompotalitatete / Fer.-An. 1046706041 Maratus Schiuva ET ";;109.00;62'711.69;
01.06.2022;01.06.2022;" Dompotalitatete / Fer.-An. 7422337054 Maratus Schiuva ET ";;129.00;62'602.69;
01.06.2022;01.06.2022;" Dompotalitatete / Fer.-An. 2262344467 Maratus Schiuva ET ";;149.00;62'473.69;
01.06.2022;01.06.2022;" Dompotalitatete / Fer.-An. 6832550675 Maratus Schiuva ET ";;129.00;62'324.69;
01.06.2022;01.06.2022;" Dompotalitatete / Fer.-An. 7053385766 Maratus Schiuva ET ";;48.00;62'195.69;
01.06.2022;01.06.2022;" Dompotalitatete / Fer.-An. 8555461144 Maratus Schiuva ET ";;409.00;62'147.69;
01.06.2022;01.06.2022;" Dompotalitatete / Fer.-An. 2504505303 Maratus Schiuva ET ";;430.00;61'738.69;
01.06.2022;01.06.2022;" Dompotalitatete / Fer.-An. 8731423873 Maratus Schiuva ET ";;169.00;61'308.69;
01.06.2022;01.06.2022;" Dompotalitatete / Fer.-An. 4482337414 Minabyssit Carget SupA ";;800.00;61'139.69;
01.06.2022;01.06.2022;" Dompotalitatete / Fer.-An. 8456032007 PUENTABIT ALITTIS ET ";;1'592.89;60'339.69;
01.06.2022;01.06.2022;" Dompotalitatete / Fer.-An. 6027110022 PUENTABIT ALITTIS ET ";;302.09;58'746.80;
01.06.2022;01.06.2022;" Dompotalitatete / Fer.-An. 3752357480 Ramum Matudo Haburre ";;779.00;58'444.71;
01.06.2022;01.06.2022;" Dompotalitatete / Fer.-An. 8187151866 Nocem Lieray ";;800.00;57'665.71;
01.06.2022;31.05.2022;Obsemple-Possubilia 35556442 - DEM Visu;;100.00;56'865.71;
31.05.2022;31.05.2022;" Dompotalitatete / Fer.-An. 4231702851 CALET Decelione ET ";;609.87;56'765.71;
31.05.2022;31.05.2022;" Dompotalitatete / Fer.-An. 8278360303 Maratus Schiuva ET ";;89.00;56'155.84;
31.05.2022;31.05.2022;" Dompotalitatete / Fer.-An. 8064080087 Maratus Schiuva ET ";;64.90;56'066.84;
31.05.2022;31.05.2022;" Dompotalitatete / Fer.-An. 7071162306 Maratus Schiuva ET ";;469.00;56'001.94;
31.05.2022;31.05.2022;" Dompotalitatete / Fer.-An. 5146032812 Maratus Schiuva ET ";;79.00;55'532.94;
31.05.2022;31.05.2022;" Dompotalitatete / Fer.-An. 8472843432 Maratus Schiuva ET ";;22.90;55'453.94;
31.05.2022;31.05.2022;" Dompotalitatete / Fer.-An. 3077680508 Maratus Schiuva ET ";;249.00;55'431.04;
31.05.2022;31.05.2022;" Dompotalitatete / Fer.-An. 7434183441 Maratus Schiuva ET ";;129.00;55'182.04;
31.05.2022;31.05.2022;" Duxertibi x-mulegar / Fer.-An. 6565348377 PERIT PRIS ET ";4'217.65;;55'053.04;
31.05.2022;31.05.2022;" Dompotalitatete / Fer.-An. 3457378406 PUENTABIT ALITTIS ET ";;1'538.41;59'270.69;
31.05.2022;31.05.2022;" Dompotalitatete / Fer.-An. 1565527478 PUENTABIT ALITTIS ET ";;2'830.90;57'732.28;
31.05.2022;31.05.2022;" Dompotalitatete / Fer.-An. 2316377608 PUENTABIT ALITTIS ET ";;4'980.99;54'901.38;
31.05.2022;29.05.2022;Espoturres xxx Cuproxitalevarae Disu DE Plumemperare;110.73;;49'920.39;
31.05.2022;31.05.2022;" Ülocutas que 7011.4313.2476 Minabyssit Carget SupA / Fer.-An. 6400188377 ";1'000.00;;50'031.12;
31.05.2022;31.05.2022;" Detudidivigunno x-mulegar (Canent Reampagro: 6 / Fer.-An. 7465818781) ";9'143.85;;51'031.12;
31.05.2022;31.05.2022;" Dompotalitatete / Fer.-An. 3134848574 CONCULARTUMN OS ";;291.78;60'174.97;
30.05.2022;30.05.2022;" Dompotalitatete / Fer.-An. 1315636882 CALET Decelione ET ";;338.45;59'883.19;
30.05.2022;30.05.2022;" Dompotalitatete / Fer.-An. 4070170847 Maratus Schiuva ET ";;329.00;59'544.74;
30.05.2022;30.05.2022;" Dompotalitatete / Fer.-An. 4767244000 Maratus Schiuva ET ";;329.00;59'215.74;
30.05.2022;30.05.2022;" Dompotalitatete / Fer.-An. 6064588203 Maratus Schiuva ET ";;129.00;58'886.74;
30.05.2022;30.05.2022;" Dompotalitatete / Fer.-An. 5524744878 Maratus Schiuva ET ";;210.00;58'757.74;
30.05.2022;30.05.2022;" Dompotalitatete / Fer.-An. 1282178860 Maratus Schiuva ET ";;69.90;58'547.74;
30.05.2022;30.05.2022;" Dompotalitatete / Fer.-An. 6624665043 Maratus Schiuva ET ";;329.00;58'477.84;
30.05.2022;30.05.2022;" Dompotalitatete / Fer.-An. 4408131452 Maratus Schiuva ET ";;64.90;58'148.84;
30.05.2022;30.05.2022;" Dompotalitatete / Fer.-An. 5061668724 Maratus Schiuva ET ";;58.00;58'083.94;
30.05.2022;30.05.2022;" Dompotalitatete / Fer.-An. 2362285703 Maratus Schiuva ET ";;198.00;58'025.94;
30.05.2022;30.05.2022;" Dompotalitatete / Fer.-An. 3673616623 Maratus Schiuva ET ";;430.00;57'827.94;
30.05.2022;30.05.2022;" Dompotalitatete / Fer.-An. 7718458104 Maratus Schiuva ET ";;329.00;57'397.94;
30.05.2022;30.05.2022;" Dompotalitatete / Fer.-An. 4542327282 Maratus Schiuva ET ";;129.00;57'068.94;
30.05.2022;30.05.2022;" Dompotalitatete / Fer.-An. 1740473036 Maratus Schiuva ET ";;349.00;56'939.94;
30.05.2022;30.05.2022;" Dompotalitatete / Fer.-An. 6616058662 CUNCTO TEM TAM ";;3'000.00;56'590.94;
30.05.2022;30.05.2022;" Dompotalitatete / Fer.-An. 7541271352 MAXIMUM PEREA LOCUTALLIS SOLVENDIONE 65 VI 5572 MOLUS ET Minvente: PENTIURRUNTIS 82135 ";;1'265.00;53'590.94;
30.05.2022;30.05.2022;" Duxertibi x-mulegar / Fer.-An. 8442806706 HORIGE ETUBIT NUNTEQUE MERETIRUNT 81 3535 SCET Ipascultum: PARE ";3'543.65;;52'325.94;
30.05.2022;30.05.2022;" Duxertibi x-mulegar / Fer.-An. 7363424443 VEGUN COR DERETE BASPUTAGRATONDAS 15 8050 DOLLIGUNGULLITI Ipascultum: PARE ";1'114.20;;55'869.59;
30.05.2022;30.05.2022;" Duxertibi x-mulegar / Fer.-An. 8655440100 INGUNIFINCH SUPA PAGNIBURENDO 73 7072 TIMORPUTAS Ipascultum: EA62/712168 Achium: DEO 7'332.13 Miundimicum: 6.124150 (DEO/CAT) ";2'839.57;;56'983.79;
30.05.2022;30.05.2022;" Dompotalitatete / Fer.-An. 8275881813 PUENTABIT ALITTIS ET OMULTUMULCERATA 528 VI 2725 QUAESUS Minvente: SUM / 644.87/AN.7886520462/XXX. 8.77/CUM.64.87.1772/Minabyssit Carget Os/Visu ";;458.98;59'823.36;
30.05.2022;30.05.2022;" Dompotalitatete / Fer.-An. 4610482574 PUENTABIT ALITTIS ET OMULTUMULCERATA 528 VI 2725 QUAESUS Minvente: SUM / 853.80/AN.3550363021/XXX. 6.45/CUM.74.87.1772/Minabyssit Carget Os/Visu ";;199.98;59'364.38;
30.05.2022;29.05.2022;Obsemple-Possubilia 35556442 - DEM Visu Entendo Velis Sidescerrunt 75834215 55.87.1772 42:28;;4'800.00;59'164.40;
30.05.2022;27.05.2022;Espoturres xxx Cuproxitalevarae Dionis Reginote Entendo Velis Sidescerrunt 75834215 75.87.1772 16:55;30.00;;54'364.40;
27.05.2022;27.05.2022;" Dompotalitatete / Fer.-An. 7183368342 ColeRcitumn ET Fortentempere 77 4704 Solo VI Minvente: COLERCITUMN A-RECTUOR aurre://tenda comusquarass.vi RFMX11QL2444708 827 34557F74466455350417 MICONE CAT 510 .87. XXX CAT 6.41 ";;132.26;54'394.40;
27.05.2022;27.05.2022;" Duxertibi x-mulegar / Fer.-An. 1802448001 LTDRT03.HAT ET TALITIORGENTIORTE 44 4613 HENTI Ipascultum: LITUM SALLUUNTUUNT ";3'769.50;;54'262.14;
27.05.2022;27.05.2022;" Duxertibi x-mulegar / Fer.-An. 6855172725 QUILLE XXX PIRAERUNT 20 6452 VISU Ipascultum: PARE ";2'240.45;;58'031.64;
27.05.2022;27.05.2022;" Duxertibi x-mulegar / Fer.-An. 2805563640 I. PERINI PETIA E/D O PATIME 36 O XXX 2111 SUPERIS Ipascultum: WIROPRIUVICA Achium: DEO 7'285.87 Miundimicum: 6.602530 (DEO/CAT) ";2'616.17;;60'272.09;
27.05.2022;27.05.2022;" Duxertibi x-mulegar / Fer.-An. 6821470121 INGUNIFINCH SUPA PAGNIBURENDO 73 7072 TIMORPUTAS Ipascultum: EA62/887451 Achium: DEO 6'146.44 Miundimicum: 6.602530 (DEO/CAT) ";1'072.37;;62'888.26;
27.05.2022;27.05.2022;" Duxertibi x-mulegar / Fer.-An. 7746630102 STRICOMPROTE DERSUFFER Ipascultum: 5070 4367 3615 8017 Achium: DEO 6'641.41 Miundimicum: 6.602530 (DEO/CAT) ";3'225.99;;63'960.63;
27.05.2022;27.05.2022;" Dompotalitatete / Fer.-An. 2068615625 PUENTABIT ALITTIS ET OMULTUMULCERATA 528 VI 2725 QUAESUS Minvente: SUM / 788.87/AN.5007367520/XXX. 73.37/CUM.22.87.1772/Minabyssit Carget Os/Visu ";;602.27;67'186.62;
27.05.2022;27.05.2022;" Dompotalitatete / Fer.-An. 5731083442 Adultuunt-Quille. Funium Densidentam 8 3840 Flatintumnius VI Minvente: 18173630 ";;50.00;66'584.35;
26.05.2022;26.05.2022;Obsemple-Possubilia 35556442 - DEM Visu Entendo Velis Sidescerrunt 75834215 64.87.1772 71:65;;1'470.00;66'534.35;
25.05.2022;25.05.2022;" Dompotalitatete / Fer.-An. 1654373378 Maratus Schiuva ET Materuniustanerita 86 2725 Restom VI Minvente: 27801411 ";;139.00;65'064.35;
25.05.2022;25.05.2022;" Dompotalitatete / Fer.-An. 5175508756 Maratus Schiuva ET Materuniustanerita 86 2725 Restom VI Minvente: 22145877 ";;160.00;64'925.35;
25.05.2022;25.05.2022;" Dompotalitatete / Fer.-An. 4614143355 Maratus Schiuva ET Materuniustanerita 86 2725 Restom VI Minvente: 52282878 ";;79.00;64'765.35;
25.05.2022;25.05.2022;" Dompotalitatete / Fer.-An. 8827680216 Maratus Schiuva ET Materuniustanerita 86 2725 Restom VI Minvente: 57007107 ";;129.00;64'686.35;
25.05.2022;25.05.2022;" Dompotalitatete / Fer.-An. 6606737766 Maratus Schiuva ET Materuniustanerita 86 2725 Restom VI Minvente: 35277126 ";;516.00;64'557.35;
25.05.2022;25.05.2022;" Dompotalitatete / Fer.-An. 5524684127 Maratus Schiuva ET Materuniustanerita 86 2725 Restom VI Minvente: 43171567 ";;129.00;64'041.35;
25.05.2022;25.05.2022;" Dompotalitatete / Fer.-An. 6871666801 Maratus Schiuva ET Materuniustanerita 86 2725 Restom VI Minvente: 70186333 ";;109.00;63'912.35;
25.05.2022;25.05.2022;" Dompotalitatete / Fer.-An. 5735155128 Maratus Schiuva ET Materuniustanerita 86 2725 Restom VI Minvente: 66085568 ";;129.00;63'803.35;
25.05.2022;25.05.2022;" Dompotalitatete / Fer.-An. 5043188870 Maratus Schiuva ET Materuniustanerita 86 2725 Restom VI Minvente: 74186130 ";;100.00;63'674.35;
25.05.2022;25.05.2022;" Dompotalitatete / Fer.-An. 2262227764 Maratus Schiuva ET Materuniustanerita 86 2725 Restom VI Minvente: 53322187 ";;139.00;63'574.35;
25.05.2022;25.05.2022;" Dompotalitatete / Fer.-An. 2617675708 Maratus Schiuva ET Materuniustanerita 86 2725 Restom VI Minvente: 66411738 ";;79.00;63'435.35;
25.05.2022;25.05.2022;" Dompotalitatete / Fer.-An. 4758807705 Maratus Schiuva ET Materuniustanerita 86 2725 Restom VI Minvente: 75627852 ";;329.00;63'356.35;
25.05.2022;25.05.2022;" Dompotalitatete / Fer.-An. 1225713526 Maratus Schiuva ET Materuniustanerita 86 2725 Restom VI Minvente: 52523323 ";;70.01;63'027.35;
25.05.2022;25.05.2022;" Dompotalitatete / Fer.-An. 3672733048 Maratus Schiuva ET Materuniustanerita 86 2725 Restom VI Minvente: 80554711 ";;109.00;62'957.34;
25.05.2022;25.05.2022;" Dompotalitatete / Fer.-An. 5842054271 Maratus Schiuva ET Materuniustanerita 86 2725 Restom VI Minvente: 26430753 ";;189.00;62'848.34;
25.05.2022;25.05.2022;" Dompotalitatete / Fer.-An. 6483102682 CALET Decelione ET Curusquitoditagnum 35 8678 Restom VI Minvente: 566888 CALET ph43y2x2-11ev-1845-m17 6-68sp7857v536 Conimo 74681114 Frent: 510.87 Pote: -6.41 ";;132.26;62'659.34;
25.05.2022;25.05.2022;" Dompotalitatete / Fer.-An. 2750888081 Artuunt xxx Susterunt Cipta Quadicum 2342 Vispitia IN Minvente: Tenda Comusquarass Exemplebillibi: 20055267 Quonterunnem: 27121 Tentüforunt Coloäicit: Tenda Hyacutuideo ";;918.00;62'527.08;
25.05.2022;25.05.2022;" Duxertibi x-mulegar / Fer.-An. 1215383876 CONEIS SOLVERTIO OS DESCHRADDE MUSA ETE OPRANENSONE 7711 DEIUSTA Ipascultum: 1845 ";7.20;;61'609.08;
25.05.2022;25.05.2022;" Dompotalitatete / Fer.-An. 4206477785 PUENTABIT ALITTIS ET OMULTUMULCERATA 528 VI 2725 QUAESUS Minvente: SUM / 510.87/AN.7705660233/XXX. 8.52/CUM.73.87.1772/Tenda Comusquarass /Postorimurem ";;513.61;61'616.28;
25.05.2022;25.05.2022;" Duxertibi x-mulegar / Fer.-An. 4455434172 PARDUXORBICARY BY MORDUCCIPE Ipascultum: 628032670 Achium: DEO 804.87 Miundimicum: 6.141170 (DEO/CAT) ";156.33;;61'102.67;
25.05.2022;25.05.2022;" Duxertibi x-mulegar / Fer.-An. 7741221863 SERABO ICUTINTUM CONTI FUNDUCELIS 10U 6026 RACINAM-PRAT Ipascultum: 50081385 Achium: DEO 6'466.87 Miundimicum: 6.141170 (DEO/CAT) ";1'493.03;;61'259.00;
25.05.2022;25.05.2022;" Duxertibi x-mulegar / Fer.-An. 7128310624 INGUNIFINCH SUPA PAGNIBURENDO 73 7072 TIMORPUTAS Ipascultum: EA62/745818 Achium: DEO 7'883.46 Miundimicum: 6.141170 (DEO/CAT) ";2'582.69;;62'752.03;
25.05.2022;25.05.2022;" Duxertibi x-mulegar / Fer.-An. 8100138342 INGUNIFINCH SUPA PAGNIBURENDO 73 7072 TIMORPUTAS Ipascultum: EA62/705480 Achium: DEO 363.44 Miundimicum: 6.141170 (DEO/CAT) ";1'020.62;;65'334.72;
25.05.2022;25.05.2022;" Duxertibi x-mulegar / Fer.-An. 8868488147 INGUNIFINCH SUPA PAGNIBURENDO 73 7072 TIMORPUTAS Ipascultum: EA62/858760 Achium: DEO 6'260.75 Miundimicum: 6.141170 (DEO/CAT) ";1'326.94;;66'355.34;
25.05.2022;25.05.2022;" Duxertibi x-mulegar / Fer.-An. 7182546280 INTIS RAMENI SUPA SIVISQUIUVA 14 15451 ELLIQUAER Ipascultum: 3878131 Achium: DEO 33.17 Miundimicum: 6.141170 (DEO/CAT) ";66.46;;67'682.28;
24.05.2022;24.05.2022;" Dompotalitatete / Fer.-An. 2147818266 CONDULA FRIGE ELEST 3 VI 1428 ADIVIT Minvente: QUONTERUNNEM 64017 ";;562.00;67'748.75;
24.05.2022;24.05.2022;" Dompotalitatete / Fer.-An. 5852250517 Maratus Schiuva ET Materuniustanerita 86 2725 Restom VI Minvente: 25142055 ";;129.00;67'186.75;
24.05.2022;24.05.2022;" Dompotalitatete / Fer.-An. 7062642185 Maratus Schiuva ET Materuniustanerita 86 2725 Restom VI Minvente: 17307501 ";;49.90;67'057.75;
24.05.2022;24.05.2022;" Dompotalitatete / Fer.-An. 4636811835 Maratus Schiuva ET Materuniustanerita 86 2725 Restom VI Minvente: 23151823 ";;150.00;67'007.85;
24.05.2022;24.05.2022;" Dompotalitatete / Fer.-An. 6717407762 ColeRcitumn ET Fortentempere 77 4704 Solo VI Minvente: COLERCITUMN A-RECTUOR aurre://tenda comusquarass.vi RFMX11QL2444708 827 12370D02378657256254 MICONE CAT 377 .87. XXX CAT 1.87 ";;679.06;66'857.85;
24.05.2022;24.05.2022;" Dompotalitatete / Fer.-An. 7237346326 CONCULARTUMN OS Vos in Centabo 4 7702 Fraest BY VI Minvente: Famquini 77.87.81 - 64.87.81 ";;2'293.90;66'178.79;
24.05.2022;20.05.2022;Espoturres xxx Cuproxitalevarae REQUAE *QKN0714840444 et@requae.hat DEM Rinte Tescentiam Sidescerrunt 7671 6345 2678 6142 77.87.1772 24:44;350.00;;63'884.89;
24.05.2022;24.05.2022;" Dompotalitatete / Fer.-An. 7626407844 CALET Decelione ET Curusquitoditagnum 35 8678 Restom VI Minvente: 566888 CALET ph43y2x2-11ev-1845-m17 6-68sp7857v536 Conimo 42030643 Frent: 510.87 Pote: -6.41 ";;132.26;64'234.89;
24.05.2022;24.05.2022;" Dompotalitatete / Fer.-An. 3033753438 Volo Insiduci Mannerieciunde 36 6438 Restom VI Minvente: Monuntum.: 47088 Quoburiem: 4231 ";;1'550.00;64'102.63;
24.05.2022;24.05.2022;" Dompotalitatete / Fer.-An. 1180838208 PUENTABIT ALITTIS ET OMULTUMULCERATA 528 VI 2725 QUAESUS Minvente: SUM / 183.87/AN.8015285476/XXX. 8.17/CUM.81.87.1772/Minabyssit Carget Os/Visu ";;478.66;62'552.63;
24.05.2022;24.05.2022;" Dompotalitatete / Fer.-An. 2607852878 PUENTABIT ALITTIS ET OMULTUMULCERATA 528 VI 2725 QUAESUS Minvente: SUM / 7706.87/AN.1138860040/XXX. 36.86/CUM.16.87.1772/Tenda Comusquarass /Postorimurem ";;1'123.32;62'073.97;
24.05.2022;24.05.2022;" Dompotalitatete / Fer.-An. 7688458254 PUENTABIT ALITTIS ET OMULTUMULCERATA 528 VI 2725 QUAESUS Minvente: SUM / 6153.87/AN.4165312885/XXX. 75.30/CUM.77.87.1772/Minabyssit Carget Os/Visu ";;2'730.16;60'950.65;
24.05.2022;24.05.2022;" Dompotalitatete / Fer.-An. 2512708803 PUENTABIT ALITTIS ET OMULTUMULCERATA 528 VI 2725 QUAESUS Minvente: SUM / 3803.87/AN.6104805503/XXX. 7.87/CUM.77.87.1772/Tenda Comusquarass /Postorimurem ";;1'098.00;58'220.49;
24.05.2022;24.05.2022;" Duxertibi x-mulegar / Fer.-An. 1240414172 REQUAE MITUUNT LODIVIT CANTURRURRE: 72521536 Ipascultum: 470824081051 ";1'500.00;;57'122.49;
23.05.2022;23.05.2022;" Dompotalitatete / Fer.-An. 1234572556 Maratus Schiuva ET Materuniustanerita 86 2725 Restom VI Minvente: 68233567 ";;275.00;58'622.49;
23.05.2022;23.05.2022;" Dompotalitatete / Fer.-An. 3536032732 Maratus Schiuva ET Materuniustanerita 86 2725 Restom VI Minvente: 43185277 ";;33.90;58'347.49;
23.05.2022;23.05.2022;" Dompotalitatete / Fer.-An. 4687862275 Maratus Schiuva ET Materuniustanerita 86 2725 Restom VI Minvente: 48806024 ";;129.00;58'313.59;
23.05.2022;23.05.2022;" Dompotalitatete / Fer.-An. 1071874012 Maratus Schiuva ET Materuniustanerita 86 2725 Restom VI Minvente: 26687230 ";;33.90;58'184.59;
23.05.2022;23.05.2022;" Dompotalitatete / Fer.-An. 5272803132 Maratus Schiuva ET Materuniustanerita 86 2725 Restom VI Minvente: 27457377 ";;129.00;58'150.69;
23.05.2022;23.05.2022;" Dompotalitatete / Fer.-An. 2215626815 Maratus Schiuva ET Materuniustanerita 86 2725 Restom VI Minvente: 43421321 ";;106.80;58'021.69;
23.05.2022;23.05.2022;" Dompotalitatete / Fer.-An. 7203001637 Tinvalum Caut Pugatincus 65 VI-1858 Pecutas Minvente: NOCASTA-AN. 75564734 FUNNERIENTICA CALE PAUCCUS RIMUNT-AN. 16454 ";;161.00;57'914.89;
23.05.2022;23.05.2022;" Dompotalitatete / Fer.-An. 1484642047 CALET Decelione ET Curusquitoditagnum 35 8678 Restom VI Minvente: 566888 CALET ph43y2x2-11ev-1845-m17 6-68sp7857v536 Conimo 28606168 Frent: 1860.87 Pote: -22.75 ";;1'842.73;57'753.89;
23.05.2022;23.05.2022;" Dompotalitatete / Fer.-An. 2427837281 MULII LEBRA INENTUDO SALIURRENEST 22 54824 STATUDITE VI Minvente: /CEM/LES.523.BY.274200 CAPERAHEDE 22826273 - SENDITUUNTATU Achium: DEO 573.87 Miundimicum: 6.265406 (DEO/CAT) ";;203.41;55'911.16;
23.05.2022;23.05.2022;" Duxertibi x-mulegar / Fer.-An. 6220213683 MARATUS SCHIUVA ET MATERUNIUSTANERITA 41Y VI-2725 QUAESUS Ipascultum: CALTUBIT 50262336 ";3'710.46;;55'707.75;
23.05.2022;23.05.2022;" Duxertibi x-mulegar / Fer.-An. 2832051353 MARATUS SCHIUVA ET MATERUNIUSTANERITA 41Y VI-2725 QUAESUS Ipascultum: CALTUBIT 18688530 ";1'002.00;;59'418.21;
23.05.2022;23.05.2022;" Dompotalitatete / Fer.-An. 6615783568 Minabyssit Carget SupA Piraerunt 20 6452 Visu VI Minvente: Plibulus ";;1'300.00;60'420.21;
23.05.2022;23.05.2022;" Dompotalitatete / Fer.-An. 7438102811 PUENTABIT ALITTIS ET OMULTUMULCERATA 528 VI 2725 QUAESUS Minvente: SUM / 2338.87/AN.7624832303/XXX. 64.52/CUM.42.87.1772/Minabyssit Carget Os/Visu ";;1'359.61;59'120.21;
23.05.2022;23.05.2022;" Dompotalitatete / Fer.-An. 2150858367 PUENTABIT ALITTIS ET OMULTUMULCERATA 528 VI 2725 QUAESUS Minvente: SUM / 122.87/AN.3557703186/XXX. 8.84/CUM.42.87.1772/Tenda Comusquarass /Postorimurem ";;667.91;57'760.60;
23.05.2022;23.05.2022;" Dompotalitatete / Fer.-An. 1138223484 Acciliunt RECT SupA Ungungus 76 6674 Faculi VI Minvente: Ascentro Duongun/GT8025348535/MK62624044/TD7/MF3550.75/OS-80.35 ";;3'011.17;57'092.69;
23.05.2022;23.05.2022;" Dompotalitatete / Fer.-An. 6672718682 Haradde Fabitam Tensus Exerficus 6 6438 Quaesus VI Minvente: Pentiurruntis .36070 ";;204.00;54'081.52;
20.05.2022;20.05.2022;" Dompotalitatete / Fer.-An. 8432116868 CALET Decelione ET Curusquitoditagnum 35 8678 Restom VI Minvente: 566888 CALET ph43y2x2-11ev-1845-m17 6-68sp7857v536 Conimo 72136616 Frent: 67.87 Pote: -8.67 ";;63.17;53'877.52;
20.05.2022;20.05.2022;" Duxertibi x-mulegar / Fer.-An. 8174665854 DEPRIT CARGET NATEMENS SUPA TUITQUONSIEM 65 4184 COMINATE Ipascultum: CALTUBIT 5130523071 ";1'126.25;;53'814.35;
20.05.2022;20.05.2022;" Duxertibi x-mulegar / Fer.-An. 7684826332 ET INIUSTA OCULI F/ JUBIEREGANARADA RONIANAVIDE Ipascultum: 546473 688350 256245 468580 Achium: DEO 6'504.68 Miundimicum: 6.134635 (DEO/CAT) ";1'588.65;;54'940.60;
19.05.2022;19.05.2022;" Dompotalitatete / Fer.-An. 1713876787 Maratus Schiuva ET Materuniustanerita 86 2725 Restom VI Minvente: 78513272 ";;179.00;56'529.25;
19.05.2022;19.05.2022;" Dompotalitatete / Fer.-An. 3588607662 Maratus Schiuva ET Materuniustanerita 86 2725 Restom VI Minvente: 33751682 ";;189.00;56'350.25;
19.05.2022;19.05.2022;" Dompotalitatete / Fer.-An. 3645251763 Maratus Schiuva ET Materuniustanerita 86 2725 Restom VI Minvente: 61027656 ";;409.00;56'161.25;
19.05.2022;19.05.2022;" Dompotalitatete / Fer.-An. 3354622035 Maratus Schiuva ET Materuniustanerita 86 2725 Restom VI Minvente: 88554625 ";;189.00;55'752.25;
19.05.2022;19.05.2022;" Dompotalitatete / Fer.-An. 6725147753 Maratus Schiuva ET Materuniustanerita 86 2725 Restom VI Minvente: 10565538 ";;129.00;55'563.25;
19.05.2022;19.05.2022;" Dompotalitatete / Fer.-An. 4455378482 Maratus Schiuva ET Materuniustanerita 86 2725 Restom VI Minvente: 71522648 ";;15.90;55'434.25;
19.05.2022;19.05.2022;" Dompotalitatete / Fer.-An. 6385444771 Maratus Schiuva ET Materuniustanerita 86 2725 Restom VI Minvente: 32321346 ";;158.00;55'418.35;
19.05.2022;19.05.2022;" Dompotalitatete / Fer.-An. 7813538318 Maratus Schiuva ET Materuniustanerita 86 2725 Restom VI Minvente: 70250810 ";;109.00;55'260.35;
19.05.2022;19.05.2022;" Dompotalitatete / Fer.-An. 5174000855 Maratus Schiuva ET Materuniustanerita 86 2725 Restom VI Minvente: 81821161 ";;259.00;55'151.35;
19.05.2022;19.05.2022;" Dompotalitatete / Fer.-An. 7347148061 Maratus Schiuva ET Materuniustanerita 86 2725 Restom VI Minvente: 34711306 ";;129.00;54'892.35;
19.05.2022;19.05.2022;" Dompotalitatete / Fer.-An. 1413082088 CALET Decelione ET Curusquitoditagnum 35 8678 Restom VI Minvente: 566888 CALET ph43y2x2-11ev-1845-m17 6-68sp7857v536 Conimo 73504820 Frent: 616.44 Pote: -1.87 ";;551.70;54'763.35;
19.05.2022;19.05.2022;Obsemple-Possubilia 35556442 - DEM Visu Entendo Velis Sidescerrunt 75834215 42.87.1772 53:76;;1'800.00;54'211.65;
19.05.2022;18.05.2022;Espoturres xxx Cuproxitalevarae REQUAE *QKN0714840444 et@requae.hat DEM Rinte Tescentiam Sidescerrunt 7671 6345 2678 6142 76.87.1772 47:44;1'000.00;;52'411.65;
19.05.2022;19.05.2022;" Duxertibi x-mulegar / Fer.-An. 6818468831 PUPA ANES SUPA 4774 AGRUS Ipascultum: 15322 ";339.65;;53'411.65;
19.05.2022;19.05.2022;" Duxertibi x-mulegar / Fer.-An. 8440076002 PUPA ANES SUPA 4774 AGRUS Ipascultum: 37437 ";1'092.15;;53'751.30;
19.05.2022;19.05.2022;" Dompotalitatete / Fer.-An. 4643563618 PUENTABIT ALITTIS ET OMULTUMULCERATA 528 VI 2725 QUAESUS Minvente: SUM / 510.87/AN.5186622221/XXX. 7.27/CUM.20.87.1772/Minabyssit Carget Os/Visu ";;131.55;54'843.45;
19.05.2022;19.05.2022;" Duxertibi x-mulegar / Fer.-An. 3404458216 I. PERINI PETIA E/D O PATIME 36 O XXX 2111 SUPERIS Ipascultum: WIROPRIUVICA Achium: DEO 7'285.87 Miundimicum: 6.714675 (DEO/CAT) ";2'630.43;;54'711.90;
18.05.2022;18.05.2022;" Dompotalitatete / Fer.-An. 1245133423 Maratus Schiuva ET Materuniustanerita 86 2725 Restom VI Minvente: 65547754 ";;189.00;57'342.33;
18.05.2022;18.05.2022;" Dompotalitatete / Fer.-An. 4225034663 Maratus Schiuva ET Materuniustanerita 86 2725 Restom VI Minvente: 85816155 ";;79.00;57'153.33;
18.05.2022;18.05.2022;" Dompotalitatete / Fer.-An. 3550740582 Maratus Schiuva ET Materuniustanerita 86 2725 Restom VI Minvente: 20843680 ";;79.00;57'074.33;
18.05.2022;18.05.2022;" Dompotalitatete / Fer.-An. 8607783581 Maratus Schiuva ET Materuniustanerita 86 2725 Restom VI Minvente: 74413580 ";;79.00;56'995.33;
18.05.2022;18.05.2022;" Dompotalitatete / Fer.-An. 3028208002 Maratus Schiuva ET Materuniustanerita 86 2725 Restom VI Minvente: 40550406 ";;109.00;56'916.33;
18.05.2022;18.05.2022;" Dompotalitatete / Fer.-An. 4582237814 Maratus Schiuva ET Materuniustanerita 86 2725 Restom VI Minvente: 22436331 ";;79.00;56'807.33;
18.05.2022;18.05.2022;" Dompotalitatete / Fer.-An. 4448126423 Maratus Schiuva ET Materuniustanerita 86 2725 Restom VI Minvente: 85332570 ";;129.00;56'728.33;
18.05.2022;18.05.2022;" Dompotalitatete / Fer.-An. 3418008647 Maratus Schiuva ET Materuniustanerita 86 2725 Restom VI Minvente: 83516100 ";;349.00;56'599.33;
18.05.2022;18.05.2022;" Dompotalitatete / Fer.-An. 8068578751 Maratus Schiuva ET Materuniustanerita 86 2725 Restom VI Minvente: 83532084 ";;109.00;56'250.33;
18.05.2022;18.05.2022;" Dompotalitatete / Fer.-An. 8261885275 Maratus Schiuva ET Materuniustanerita 86 2725 Restom VI Minvente: 35684438 ";;79.00;56'141.33;
18.05.2022;18.05.2022;" Dompotalitatete / Fer.-An. 1552351762 Maratus Schiuva ET Materuniustanerita 86 2725 Restom VI Minvente: 30020041 ";;510.00;56'062.33;
18.05.2022;18.05.2022;" Dompotalitatete / Fer.-An. 3641613681 Maratus Schiuva ET Materuniustanerita 86 2725 Restom VI Minvente: 84673562 ";;129.00;55'552.33;
18.05.2022;18.05.2022;" Dompotalitatete / Fer.-An. 2306172855 PUENTABIT ALITTIS ET OMULTUMULCERATA 528 VI 2725 QUAESUS Minvente: SUM / 8352.80/AN.4380236455/XXX. 67.25/CUM.36.87.1772/Tenda Comusquarass /Postorimurem ";;4'451.28;55'423.33;
18.05.2022;18.05.2022;" Dompotalitatete / Fer.-An. 6274267561 PUENTABIT ALITTIS ET OMULTUMULCERATA 528 VI 2725 QUAESUS Minvente: SUM / 275.87/AN.5223142041/XXX. 7.68/CUM.36.87.1772/Minabyssit Carget Os/Visu ";;141.22;50'972.05;
18.05.2022;18.05.2022;" Duxertibi x-mulegar / Fer.-An. 6556867585 MENIUM TORA LIQUAM T'ALIRE 74 6762 PASCRETE ";673.02;;50'830.83;
17.05.2022;17.05.2022;" Dompotalitatete / Fer.-An. 6628468077 Maratus Schiuva ET Materuniustanerita 86 2725 Restom VI Minvente: 84774870 ";;359.00;51'503.85;
17.05.2022;17.05.2022;" Dompotalitatete / Fer.-An. 1734535064 Maratus Schiuva ET Materuniustanerita 86 2725 Restom VI Minvente: 66314026 ";;109.00;51'144.85;
17.05.2022;17.05.2022;" Dompotalitatete / Fer.-An. 7401512163 Maratus Schiuva ET Materuniustanerita 86 2725 Restom VI Minvente: 25038884 ";;129.00;51'035.85;
17.05.2022;17.05.2022;" Dompotalitatete / Fer.-An. 7385465088 Maratus Schiuva ET Materuniustanerita 86 2725 Restom VI Minvente: 88312871 ";;26.90;50'906.85;
17.05.2022;17.05.2022;" Dompotalitatete / Fer.-An. 3801204855 Maratus Schiuva ET Materuniustanerita 86 2725 Restom VI Minvente: 54874357 ";;79.00;50'879.95;
17.05.2022;17.05.2022;" Dompotalitatete / Fer.-An. 2603120177 CONCULARTUMN OS Vos in Centabo 4 7702 Fraest BY VI Minvente: Famquini 52.87.81 - 42.87.81 ";;2'893.05;50'800.95;
17.05.2022;14.05.2022;Espoturres xxx Cuproxitalevarae REQUAE *QKN0714840444 et@requae.hat DEM Rinte Tescentiam Sidescerrunt 7671 6345 2678 6142 65.87.1772 87:81;1'000.00;;47'907.90;
17.05.2022;17.05.2022;" Dompotalitatete / Fer.-An. 8228183376 TEST SOLONUNDE SOLUMN COMPELONATUOBULA 22 VI 7317 PARE CERANGURAM ";;209.00;48'907.90;
17.05.2022;17.05.2022;" Dompotalitatete / Fer.-An. 2782201874 PUENTABIT ALITTIS ET OMULTUMULCERATA 528 VI 2725 QUAESUS Minvente: SUM / 232.80/AN.5200656755/XXX. 5.53/CUM.58.87.1772/Minabyssit Carget Os/Visu ";;330.44;48'698.90;
17.05.2022;17.05.2022;" Duxertibi x-mulegar / Fer.-An. 7355426838 RAPPOST NOVISUM D.I.E 13781 CARESSICUTUR PULIGUN Ipascultum: 1412065720 Achium: DEO 218.15 Miundimicum: 6.741035 (DEO/CAT) ";133.44;;48'368.46;
17.05.2022;17.05.2022;" Duxertibi x-mulegar / Fer.-An. 1450103022 WIRERRE-MODIX SALIA SUPA + EX. OS NUNT-SALIA-DUCEAT 5 23116 PRODICILE RONIANAVIDE Ipascultum: 24684565 Achium: DEO 603.64 Miundimicum: 6.741035 (DEO/CAT) ";165.16;;48'501.90;
17.05.2022;17.05.2022;" Duxertibi x-mulegar / Fer.-An. 6675721036 INTIS RAMENI SUPA SIVISQUIUVA 14 15451 ELLIQUAER Ipascultum: 3208165 Achium: DEO 116.84 Miundimicum: 6.741035 (DEO/CAT) ";515.46;;48'667.06;
17.05.2022;17.05.2022;" Duxertibi x-mulegar / Fer.-An. 1261653145 INTIS RAMENI SUPA SIVISQUIUVA 14 15451 ELLIQUAER Ipascultum: 1606672 Achium: DEO 6'520.56 Miundimicum: 6.741035 (DEO/CAT) ";1'915.65;;49'182.52;
17.05.2022;17.05.2022;" Duxertibi x-mulegar / Fer.-An. 5716265186 INTIS RAMENI SUPA SIVISQUIUVA 14 15451 ELLIQUAER Ipascultum: 6362631 Achium: DEO 307.42 Miundimicum: 6.741035 (DEO/CAT) ";586.34;;51'098.17;
17.05.2022;17.05.2022;" Duxertibi x-mulegar / Fer.-An. 4327104257 INTIS RAMENI SUPA SIVISQUIUVA 14 15451 ELLIQUAER Ipascultum: 4186368 Achium: DEO 868.17 Miundimicum: 6.741035 (DEO/CAT) ";292.28;;51'684.51;
17.05.2022;17.05.2022;" Duxertibi x-mulegar / Fer.-An. 7203822640 INTIS RAMENI SUPA SIVISQUIUVA 14 15451 ELLIQUAER Ipascultum: 8330735 Achium: DEO 850.28 Miundimicum: 6.741035 (DEO/CAT) ";106.75;;51'976.79;
17.05.2022;17.05.2022;" Duxertibi x-mulegar / Fer.-An. 1040155564 INTIS RAMENI SUPA SIVISQUIUVA 14 15451 ELLIQUAER Ipascultum: 3230022 Achium: DEO 327.17 Miundimicum: 6.741035 (DEO/CAT) ";474.18;;52'083.54;
17.05.2022;17.05.2022;" Duxertibi x-mulegar / Fer.-An. 5356380048 DEPRIT CARGET NATEMENS SUPA TUITQUONSIEM 65 4184 COMINATE Ipascultum: CALTUBIT 8350043541 ";3'245.00;;52'557.72;
17.05.2022;17.05.2022;" Duxertibi x-mulegar / Fer.-An. 5460402283 ACIT ANSIVIMEN E/D XXX 66326610 EMPUGE 448 DE-5253 ALIBI Ipascultum: 6624306 ";147.43;;55'802.72;
17.05.2022;17.05.2022;" Duxertibi x-mulegar / Fer.-An. 1102657756 SUARESTAS PLUMN GRIEIUSQUIDE 5 3061 IUSIMETINI Ipascultum: 41544182 10063613 32537408 ";647.99;;55'950.15;
17.05.2022;17.05.2022;" Duxertibi x-mulegar / Fer.-An. 2305656003 INCUNTO ADDUERADO ET PAURREHETTETUS 4 4074 SIVENGULLA ";413.15;;56'598.14;
17.05.2022;17.05.2022;" Dompotalitatete / Fer.-An. 7147285373 PUENTABIT ALITTIS ET OMULTUMULCERATA 528 VI 2725 QUAESUS Minvente: SUM / 305.87/AN.1534781813/XXX. 8.24/CUM.65.87.1772/Minabyssit Carget Os/Visu ";;303.03;57'011.29;
17.05.2022;17.05.2022;" Dompotalitatete / Fer.-An. 6063285406 PUENTABIT ALITTIS ET OMULTUMULCERATA 528 VI 2725 QUAESUS Minvente: SUM / 4233.87/AN.6062074416/XXX. 5.27/CUM.52.87.1772/Tenda Comusquarass /Postorimurem ";;1'131.21;56'708.26;
17.05.2022;17.05.2022;" Dompotalitatete / Fer.-An. 7516642551 PUENTABIT ALITTIS ET OMULTUMULCERATA 528 VI 2725 QUAESUS Minvente: SUM / 513.87/AN.8770878716/XXX. 5.68/CUM.52.87.1772/Minabyssit Carget Os/Visu ";;244.22;55'577.05;
17.05.2022;17.05.2022;" Dompotalitatete / Fer.-An. 6708524220 Vit Opraxi Serundicunt 71 VI-6337 Spiratur Minvente: AMETE EINAVINGULUMERATUSA ";;189.00;55'332.83;
16.05.2022;16.05.2022;" Dompotalitatete / Fer.-An. 5451573168 Maratus Schiuva ET Materuniustanerita 86 2725 Restom VI Minvente: 75703535 ";;338.00;55'143.83;
16.05.2022;16.05.2022;" Dompotalitatete / Fer.-An. 1634641850 Maratus Schiuva ET Materuniustanerita 86 2725 Restom VI Minvente: 48654085 ";;159.00;54'805.83;
16.05.2022;16.05.2022;" Dompotalitatete / Fer.-An. 6172142485 Maratus Schiuva ET Materuniustanerita 86 2725 Restom VI Minvente: 44772147 ";;74.00;54'646.83;
16.05.2022;16.05.2022;" Dompotalitatete / Fer.-An. 7155885612 Maratus Schiuva ET Materuniustanerita 86 2725 Restom VI Minvente: 60582200 ";;559.00;54'572.83;
16.05.2022;16.05.2022;" Dompotalitatete / Fer.-An. 8587371046 Maratus Schiuva ET Materuniustanerita 86 2725 Restom VI Minvente: 31601567 ";;79.00;54'013.83;
16.05.2022;16.05.2022;" Dompotalitatete / Fer.-An. 3520882577 Maratus Schiuva ET Materuniustanerita 86 2725 Restom VI Minvente: 10814100 ";;79.00;53'934.83;
16.05.2022;16.05.2022;" Dompotalitatete / Fer.-An. 6387330216 CALET Decelione ET Curusquitoditagnum 35 8678 Restom VI Minvente: 566888 CALET ph43y2x2-11ev-1845-m17 6-68sp7857v536 Conimo 67682718 Frent: 8584.87 Pote: -10.84 ";;2'775.44;53'855.83;
16.05.2022;16.05.2022;" Asputulieresex / Fer.-An. 7712752017 Virantrum: MERUNTO TUUNTAVARIDEINATU Avingemüin: CAT 6.24 ";;439.00;51'080.39;
16.05.2022;16.05.2022;" Duxertibi x-mulegar / Fer.-An. 8426637337 HOC ALITTIS ET ADDUCUNTURRANAVA 35 4567 MOLUS EX ";2'696.10;;50'641.39;
16.05.2022;16.05.2022;" Dompotalitatete / Fer.-An. 5850478235 PUENTABIT ALITTIS ET OMULTUMULCERATA 528 VI 2725 QUAESUS Minvente: SUM / 203.87/AN.3267150857/XXX. 7.87/CUM.71.87.1772/Tenda Comusquarass /Postorimurem ";;587.80;53'337.49;
16.05.2022;16.05.2022;" Dompotalitatete / Fer.-An. 8371887245 PUENTABIT ALITTIS ET OMULTUMULCERATA 528 VI 2725 QUAESUS Minvente: SUM / 467.80/AN.1827722771/XXX. 5.34/CUM.71.87.1772/Minabyssit Carget Os/Visu ";;214.62;52'749.69;
16.05.2022;16.05.2022;" Dompotalitatete / Fer.-An. 5451030647 HORAEST SupA-Flus rea Ricogit Orsectuundulli 86K 6025 Poegraer VI Minvente: Agrangerre 71.87.1772 ";;366.80;52'535.07;
16.05.2022;16.05.2022;" Dompotalitatete / Fer.-An. 7112584650 Candas Eximus Cuiecent Sieniundiscrehetus 132 6438 Quaesus VI Minvente: Tenda Comusquarass Doculury-An.: 47334830 Coneincelibentus: Etubit Horige Plerunt Videtimulam 65 8q323l64ef ";;944.00;52'168.27;
13.05.2022;13.05.2022;" Dompotalitatete / Fer.-An. 3672643866 Maratus Schiuva ET Materuniustanerita 86 2725 Restom VI Minvente: 56277558 ";;59.90;51'224.27;
13.05.2022;13.05.2022;" Dompotalitatete / Fer.-An. 1644857501 Maratus Schiuva ET Materuniustanerita 86 2725 Restom VI Minvente: 38125452 ";;79.00;51'164.37;
13.05.2022;13.05.2022;" Dompotalitatete / Fer.-An. 3326662232 Maratus Schiuva ET Materuniustanerita 86 2725 Restom VI Minvente: 25224218 ";;189.00;51'085.37;
13.05.2022;13.05.2022;" Dompotalitatete / Fer.-An. 1574061220 Maratus Schiuva ET Materuniustanerita 86 2725 Restom VI Minvente: 86261088 ";;129.00;50'896.37;
13.05.2022;13.05.2022;" Dompotalitatete / Fer.-An. 7552175272 Maratus Schiuva ET Materuniustanerita 86 2725 Restom VI Minvente: 68374154 ";;25.90;50'767.37;
13.05.2022;13.05.2022;" Dompotalitatete / Fer.-An. 3661511857 Maratus Schiuva ET Materuniustanerita 86 2725 Restom VI Minvente: 40732748 ";;79.00;50'741.47;
13.05.2022;13.05.2022;" Dompotalitatete / Fer.-An. 6245276550 Maratus Schiuva ET Materuniustanerita 86 2725 Restom VI Minvente: 40621676 ";;169.00;50'662.47;
13.05.2022;13.05.2022;" Dompotalitatete / Fer.-An. 2124128038 Maratus Schiuva ET Materuniustanerita 86 2725 Restom VI Minvente: 70847752 ";;39.90;50'493.47;
13.05.2022;13.05.2022;" Dompotalitatete / Fer.-An. 4078001547 Maratus Schiuva ET Materuniustanerita 86 2725 Restom VI Minvente: 48736688 ";;29.90;50'453.57;
13.05.2022;13.05.2022;" Dompotalitatete / Fer.-An. 2853457263 Maratus Schiuva ET Materuniustanerita 86 2725 Restom VI Minvente: 57762100 ";;169.00;50'423.67;
13.05.2022;13.05.2022;" Dompotalitatete / Fer.-An. 1457734428 Maratus Schiuva ET Materuniustanerita 86 2725 Restom VI Minvente: 86183106 ";;119.00;50'254.67;
13.05.2022;13.05.2022;" Dompotalitatete / Fer.-An. 3646732737 Maratus Schiuva ET Materuniustanerita 86 2725 Restom VI Minvente: 70317632 ";;79.00;50'135.67;
13.05.2022;13.05.2022;" Dompotalitatete / Fer.-An. 2016843550 Maratus Schiuva ET Materuniustanerita 86 2725 Restom VI Minvente: 68824334 ";;69.78;50'056.67;
13.05.2022;13.05.2022;" Dompotalitatete / Fer.-An. 3521116075 Maratus Schiuva ET Materuniustanerita 86 2725 Restom VI Minvente: 38036230 ";;29.00;49'986.89;
13.05.2022;13.05.2022;" Dompotalitatete / Fer.-An. 3843226464 Maratus Schiuva ET Materuniustanerita 86 2725 Restom VI Minvente: 48034367 ";;199.00;49'957.89;
13.05.2022;13.05.2022;" Dompotalitatete / Fer.-An. 4883037245 PUENTABIT ALITTIS ET OMULTUMULCERATA 528 VI 2725 QUAESUS Minvente: SUM / 5547.87/AN.7721187878/XXX. 64.67/CUM.73.87.1772/Minabyssit Carget Os/Visu ";;1'383.36;49'758.89;
13.05.2022;13.05.2022;" Duxertibi x-mulegar / Fer.-An. 8160434303 ACIT ANSIVIMEN E/D XXX 66326610 EMPUGE 448 DE-5253 ALIBI Ipascultum: 1175818 4463462 7332487 2274834 8072660 4638201 3628034 ";959.33;;48'375.53;
12.05.2022;10.05.2022;Espoturres xxx Cuproxitalevarae REQUAE *QKN0714840444 et@requae.hat DEM Rinte Tescentiam Sidescerrunt 7671 6345 2678 6142 24.87.1772 81:33;1'132.55;;49'334.86;
12.05.2022;12.05.2022;" Dompotalitatete / Fer.-An. 5132753447 CALET Decelione ET Curusquitoditagnum 35 8678 Restom VI Minvente: 566888 CALET ph43y2x2-11ev-1845-m17 6-68sp7857v536 Conimo 78181148 Frent: 1422.87 Pote: -65.17 ";;1'120.24;50'467.41;
12.05.2022;12.05.2022;" Dompotalitatete / Fer.-An. 2055503514 BASPUT AESTATAM FRIGEREDESSUM 8 VI 3384 DINTERE Minvente: PAUCCUS ";;261.00;49'347.17;
12.05.2022;12.05.2022;" Duxertibi x-mulegar / Fer.-An. 5578007757 DEPRIT CARGET NATEMENS SUPA TUITQUONSIEM 65 4184 COMINATE Ipascultum: CALTUBIT 6103044508 ";2'040.00;;49'086.17;
12.05.2022;12.05.2022;" Duxertibi x-mulegar / Fer.-An. 6466616030 HOC ALITTIS ET ADDUCUNTURRANAVA 35 4567 MOLUS EX ";128.60;;51'126.17;
12.05.2022;12.05.2022;" Duxertibi x-mulegar / Fer.-An. 7523533501 CONEIS SOLVERTIO OS ETE OPRANENSONE, 7 7711 DEIUSTA Ipascultum: CALIDES 1838 ";53.10;;51'254.77;
12.05.2022;12.05.2022;" Duxertibi x-mulegar / Fer.-An. 6372566125 FLUMENT DICA ET INTENTEQUITA 42 2312 POSTORIMUREM Ipascultum: LITUM ";4'150.00;;51'307.87;
12.05.2022;12.05.2022;" Dompotalitatete / Fer.-An. 7662577612 PUENTABIT ALITTIS ET OMULTUMULCERATA 528 VI 2725 QUAESUS Minvente: SUM / 3715.87/AN.7836084204/XXX. 35.84/CUM.24.87.1772/Tenda Comusquarass /Postorimurem ";;4'978.44;55'457.87;
12.05.2022;12.05.2022;" Dompotalitatete / Fer.-An. 3740235036 PUENTABIT ALITTIS ET OMULTUMULCERATA 528 VI 2725 QUAESUS Minvente: SUM / 335.87/AN.7824264343/XXX. 8.73/CUM.24.87.1772/Minabyssit Carget Os/Visu ";;466.89;50'479.43;
12.05.2022;12.05.2022;" Duxertibi x-mulegar / Fer.-An. 5752273758 I. PERINI PETIA E/D O PATIME 36 O XXX 2111 SUPERIS Ipascultum: WIROPRIUVICA Achium: DEO 7'285.87 Miundimicum: 6.220386 (DEO/CAT) ";2'658.52;;50'012.54;
11.05.2022;11.05.2022;" Dompotalitatete / Fer.-An. 4651733654 Maratus Schiuva ET Materuniustanerita 86 2725 Restom VI Minvente: 40838305 ";;79.00;52'671.06;
11.05.2022;11.05.2022;" Dompotalitatete / Fer.-An. 3624870114 Maratus Schiuva ET Materuniustanerita 86 2725 Restom VI Minvente: 46020685 ";;79.00;52'592.06;
11.05.2022;11.05.2022;" Dompotalitatete / Fer.-An. 5380742686 Maratus Schiuva ET Materuniustanerita 86 2725 Restom VI Minvente: 81442623 ";;510.00;52'513.06;
11.05.2022;11.05.2022;" Dompotalitatete / Fer.-An. 7522368285 Maratus Schiuva ET Materuniustanerita 86 2725 Restom VI Minvente: 55185464 ";;139.00;52'003.06;
11.05.2022;11.05.2022;" Dompotalitatete / Fer.-An. 3670546102 Maratus Schiuva ET Materuniustanerita 86 2725 Restom VI Minvente: 16323632 ";;59.90;51'864.06;
11.05.2022;11.05.2022;" Dompotalitatete / Fer.-An. 1527326326 Maratus Schiuva ET Materuniustanerita 86 2725 Restom VI Minvente: 16854273 ";;169.00;51'804.16;
11.05.2022;11.05.2022;" Dompotalitatete / Fer.-An. 7102550456 Maratus Schiuva ET Materuniustanerita 86 2725 Restom VI Minvente: 68278832 ";;129.00;51'635.16;
11.05.2022;11.05.2022;" Dompotalitatete / Fer.-An. 2085215521 Maratus Schiuva ET Materuniustanerita 86 2725 Restom VI Minvente: 72543265 ";;329.00;51'506.16;
11.05.2022;11.05.2022;" Dompotalitatete / Fer.-An. 5657183847 Maratus Schiuva ET Materuniustanerita 86 2725 Restom VI Minvente: 38371730 ";;189.00;51'177.16;
11.05.2022;11.05.2022;" Dompotalitatete / Fer.-An. 3810051667 Maratus Schiuva ET Materuniustanerita 86 2725 Restom VI Minvente: 46500482 ";;109.00;50'988.16;
11.05.2022;11.05.2022;" Dompotalitatete / Fer.-An. 2330340215 Maratus Schiuva ET Materuniustanerita 86 2725 Restom VI Minvente: 38100627 ";;79.00;50'879.16;
11.05.2022;11.05.2022;" Dompotalitatete / Fer.-An. 5010471651 CALET Decelione ET Curusquitoditagnum 35 8678 Restom VI Minvente: 566888 CALET ph43y2x2-11ev-1845-m17 6-68sp7857v536 Conimo 44370870 Frent: 343.87 Pote: -5.86 ";;501.40;50'800.16;
11.05.2022;11.05.2022;" Dompotalitatete / Fer.-An. 1184728458 Minabyssit Carget SupA Piraerunt 20 6452 Visu VI ";;1'250.00;50'298.76;
11.05.2022;11.05.2022;" Duxertibi x-mulegar / Fer.-An. 1160450884 VOLLUM FORBICULA CANGE Ipascultum: CALTUBIT LUTAS 1772 ";10'800.00;;49'048.76;
11.05.2022;11.05.2022;" Duxertibi x-mulegar / Fer.-An. 2026431546 E+N REVOCUM ET SOLONTIFICULIGRACTUUS 4 2854 DENT ";5'537.85;;59'848.76;
11.05.2022;11.05.2022;" Dompotalitatete / Fer.-An. 1243445487 Acciliunt RECT SupA Ungungus 76 6674 Faculi VI Minvente: Ascentro Duongun/GT8025348535/RI08645655/TD7/DO00.88/OS-6.17 ";;56.09;65'386.61;
10.05.2022;10.05.2022;" Dompotalitatete / Fer.-An. 2854125357 CALET Decelione ET Curusquitoditagnum 35 8678 Restom VI Minvente: 566888 CALET ph43y2x2-11ev-1845-m17 6-68sp7857v536 Conimo 80377025 Frent: 7142.87 Pote: -52.30 ";;1'051.16;65'330.52;
10.05.2022;10.05.2022;" Dompotalitatete / Fer.-An. 4563074757 Maratus Schiuva ET Materuniustanerita 86 2725 Restom VI Minvente: 20222284 ";;109.00;64'279.36;
10.05.2022;10.05.2022;" Dompotalitatete / Fer.-An. 1744217558 Maratus Schiuva ET Materuniustanerita 86 2725 Restom VI Minvente: 16056588 ";;103.00;64'170.36;
10.05.2022;10.05.2022;" Dompotalitatete / Fer.-An. 1242840223 Maratus Schiuva ET Materuniustanerita 86 2725 Restom VI Minvente: 33157606 ";;199.00;64'067.36;
10.05.2022;10.05.2022;" Dompotalitatete / Fer.-An. 5372046085 Maratus Schiuva ET Materuniustanerita 86 2725 Restom VI Minvente: 34302883 ";;26.90;63'868.36;
10.05.2022;10.05.2022;" Dompotalitatete / Fer.-An. 5430660432 Maratus Schiuva ET Materuniustanerita 86 2725 Restom VI Minvente: 41811378 ";;719.01;63'841.46;
10.05.2022;10.05.2022;" Dompotalitatete / Fer.-An. 3064555702 Maratus Schiuva ET Materuniustanerita 86 2725 Restom VI Minvente: 11620060 ";;129.00;63'122.45;
10.05.2022;10.05.2022;" Dompotalitatete / Fer.-An. 5582260526 CONCULARTUMN OS Vos in Centabo 4 7702 Fraest BY VI Minvente: 18142820 ";;3'693.10;62'993.45;
10.05.2022;10.05.2022;" Dompotalitatete / Fer.-An. 4268372774 CONCULARTUMN OS Vos in Centabo 4 7702 Fraest BY VI Minvente: Famquini 81.87.81 - 71.87.81 ";;597.96;59'300.35;
10.05.2022;08.05.2022;Espoturres xxx Cuproxitalevarae PICITURUNT* U134253 SERIS DEM Rinte Tescentiam Sidescerrunt 7671 6345 2678 6142 53.87.1772 24:77 Mangustiquaest DEO 6'733.75 Fäomunispote 5 DEO = 6.665384 CAT Hocüarem CAT 6.24;1'253.40;;58'702.39;
10.05.2022;10.05.2022;" Dompotalitatete / Fer.-An. 6683253702 CALET Decelione ET Curusquitoditagnum 35 8678 Restom VI Minvente: 566888 CALET ph43y2x2-11ev-1845-m17 6-68sp7857v536 Conimo 73622636 Frent: 466.87 Pote: -8.24 ";;417.50;59'955.79;
10.05.2022;10.05.2022;" Dompotalitatete / Fer.-An. 1158714630 PUENTABIT ALITTIS ET OMULTUMULCERATA 528 VI 2725 QUAESUS Minvente: SUM / 350.87/AN.2338208404/XXX. 73.22/CUM.88.87.1772/Minabyssit Carget Os/Visu ";;608.05;59'538.29;
10.05.2022;10.05.2022;" Dompotalitatete / Fer.-An. 4455672832 PUENTABIT ALITTIS ET OMULTUMULCERATA 528 VI 2725 QUAESUS Minvente: SUM / 8281.87/AN.3205040676/XXX. 52.86/CUM.88.87.1772/Tenda Comusquarass /Postorimurem ";;4'310.40;58'930.24;
10.05.2022;10.05.2022;" Dompotalitatete / Fer.-An. 3504148510 PUENTABIT ALITTIS ET OMULTUMULCERATA 528 VI 2725 QUAESUS Minvente: SUM / 8105.44/AN.3454870404/XXX. 86.25/CUM.81.87.1772/Minabyssit Carget Os/Visu ";;3'126.78;54'619.84;
10.05.2022;10.05.2022;" Duxertibi x-mulegar / Fer.-An. 4043120015 COMERET E/D MANTI FŒNUNGA QUE 5 7674 POTABILLI DIDUXEMOR Ipascultum: PENTE ME. 23313 Achium: DEO 5'718.14 Miundimicum: 6.857544 (DEO/CAT) ";4'634.49;;51'493.06;
10.05.2022;10.05.2022;" Duxertibi x-mulegar / Fer.-An. 1212152501 SUB HORIEM 5 VOS FESSUPA 55340 RATE Ipascultum: MUM165077 Achium: DEO 340.80 Miundimicum: 6.857544 (DEO/CAT) ";495.80;;56'127.55;
09.05.2022;09.05.2022;" Dompotalitatete / Fer.-An. 1231413861 Maratus Schiuva ET Materuniustanerita 86 2725 Restom VI Minvente: 63854845 ";;129.00;56'623.35;
09.05.2022;09.05.2022;" Dompotalitatete / Fer.-An. 2254831631 Maratus Schiuva ET Materuniustanerita 86 2725 Restom VI Minvente: 53555150 ";;79.00;56'494.35;
09.05.2022;09.05.2022;" Dompotalitatete / Fer.-An. 2800365885 Maratus Schiuva ET Materuniustanerita 86 2725 Restom VI Minvente: 16431512 ";;109.00;56'415.35;
09.05.2022;09.05.2022;" Dompotalitatete / Fer.-An. 3261807207 Maratus Schiuva ET Materuniustanerita 86 2725 Restom VI Minvente: 83712260 ";;155.00;56'306.35;
09.05.2022;09.05.2022;" Duxertibi x-mulegar / Fer.-An. 1767837782 PUPA ANES SUPA 4774 AGRUS Ipascultum: 76870 ";632.30;;56'151.35;
09.05.2022;09.05.2022;" Duxertibi x-mulegar / Fer.-An. 5634072857 PUPA ANES SUPA 4774 AGRUS Ipascultum: 72742 ";265.75;;56'783.65;
09.05.2022;09.05.2022;" Duxertibi x-mulegar / Fer.-An. 1462728823 ETHENI QUADDUPA SUPA PERTEMPOSTIONGA 81 3038 SENSIME Ipascultum: PRONERVEM-AN.: 5550148266 ";43.45;;57'049.40;
09.05.2022;09.05.2022;" Duxertibi x-mulegar / Fer.-An. 6305744580 ETHENI QUADDUPA SUPA PERTEMPOSTIONGA 81 3038 SENSIME Ipascultum: PRONERVEM-AN.: 4428188171 ";42.65;;57'092.85;
09.05.2022;09.05.2022;" Dompotalitatete / Fer.-An. 5313562662 CALET Decelione ET Curusquitoditagnum 35 8678 Restom VI Minvente: 566888 CALET ph43y2x2-11ev-1845-m17 6-68sp7857v536 Conimo 38847564 Frent: 15.80 Pote: -8.20 ";;44.32;57'135.50;
09.05.2022;09.05.2022;" Dompotalitatete / Fer.-An. 2801467825 Pardunt Artuunt rier Devoluva Lonibeamisuccaudum 65 5628 Vali VI Minvente: Nocasta 10386851, Alone 56110 ";;2'895.40;57'091.18;
09.05.2022;09.05.2022;" Duxertibi x-mulegar / Fer.-An. 8413787470 SUBSEMPLUVIA PERE D.T.W. ETE SCILITAGIT 52 82286 - SENSONIFILE OS TENTAM PULIGUN Ipascultum: DICTIS SI AN. 16008 Achium: DEO 6'272.35 Miundimicum: 6.785116 (DEO/CAT) ";3'552.96;;54'195.78;
09.05.2022;09.05.2022;" Duxertibi x-mulegar / Fer.-An. 8121226821 DEPRIT CARGET NATEMENS SUPA TUITQUONSIEM 65 4184 COMINATE Ipascultum: CALTUBIT 3360170301 ";1'488.15;;57'748.74;
09.05.2022;09.05.2022;" Duxertibi x-mulegar / Fer.-An. 8817533837 TRIUM EXIMULIGUSA ET MUSQUAESPILIQUISU 5 6532 VENTESPULIQUE ";322.80;;59'236.89;
09.05.2022;09.05.2022;" Duxertibi x-mulegar / Fer.-An. 5715423233 VIMILLIUNUISUS SOLOGINGUNTIT- DEBICITE CALE GRO FLUNDIVISCURIRUNT 6438 QUAESUS ";2'993.80;;59'559.69;
09.05.2022;09.05.2022;" Dompotalitatete / Fer.-An. 8020853050 PUENTABIT ALITTIS ET OMULTUMULCERATA 528 VI 2725 QUAESUS Minvente: SUM / 4145.87/AN.8845434033/XXX. 14.68/CUM.87.87.1772/Tenda Comusquarass /Postorimurem ";;2'236.22;62'553.49;
09.05.2022;09.05.2022;" Dompotalitatete / Fer.-An. 2855410371 Pagna Rincect d/w Pratuum Nunduculumn Geriury 3b 3215 Secertinate Minvente: Caperahede 26661445 rincect pagna ";;2'745.00;60'317.27;
09.05.2022;05.05.2022;Espoturres xxx Cuproxitalevarae REQUAE *QKN0714840444 et@requae.hat DEM Rinte Tescentiam Sidescerrunt 7671 6345 2678 6142 87.87.1772 88:81;1'000.00;;57'572.27;
06.05.2022;06.05.2022;Obsemple-Atuum 35556442 - DEM Visu Entendo Velis Sidescerrunt 75834215 81.87.1772 58:55;2'000.00;;58'572.27;
06.05.2022;06.05.2022;" Dompotalitatete / Fer.-An. 6157065563 CUNCTO TEM TAM REGRATE CASE 84-11 NIFFER CECUM 3 MENSIDIPE 84236 SI 84236 Minvente: 2305605544068 ";;1'911.69;60'572.27;
06.05.2022;06.05.2022;" Dompotalitatete / Fer.-An. 1608854033 Maratus Schiuva ET Materuniustanerita 86 2725 Restom VI Minvente: 43183522 ";;349.00;58'660.58;
06.05.2022;06.05.2022;" Dompotalitatete / Fer.-An. 6048577344 Maratus Schiuva ET Materuniustanerita 86 2725 Restom VI Minvente: 23870875 ";;79.00;58'311.58;
06.05.2022;06.05.2022;" Dompotalitatete / Fer.-An. 2473817010 Maratus Schiuva ET Materuniustanerita 86 2725 Restom VI Minvente: 11180722 ";;409.00;58'232.58;
06.05.2022;06.05.2022;" Dompotalitatete / Fer.-An. 2172787158 Maratus Schiuva ET Materuniustanerita 86 2725 Restom VI Minvente: 76163361 ";;510.00;57'823.58;
06.05.2022;06.05.2022;" Dompotalitatete / Fer.-An. 1205763728 Maratus Schiuva ET Materuniustanerita 86 2725 Restom VI Minvente: 41345763 ";;469.00;57'313.58;
06.05.2022;06.05.2022;" Dompotalitatete / Fer.-An. 5456352048 Maratus Schiuva ET Materuniustanerita 86 2725 Restom VI Minvente: 20110776 ";;79.00;56'844.58;
06.05.2022;06.05.2022;" Dompotalitatete / Fer.-An. 4128246676 Maratus Schiuva ET Materuniustanerita 86 2725 Restom VI Minvente: 65068166 ";;169.00;56'765.58;
06.05.2022;06.05.2022;" Dompotalitatete / Fer.-An. 5640167850 Maratus Schiuva ET Materuniustanerita 86 2725 Restom VI Minvente: 68438265 ";;109.00;56'596.58;
06.05.2022;06.05.2022;" Dompotalitatete / Fer.-An. 7202114346 Maratus Schiuva ET Materuniustanerita 86 2725 Restom VI Minvente: 11724607 ";;79.00;56'487.58;
06.05.2022;06.05.2022;" Dompotalitatete / Fer.-An. 8237407460 Maratus Schiuva ET Materuniustanerita 86 2725 Restom VI Minvente: 23040516 ";;79.00;56'408.58;
06.05.2022;06.05.2022;" Dompotalitatete / Fer.-An. 5208565882 Maratus Schiuva ET Materuniustanerita 86 2725 Restom VI Minvente: 14071407 ";;235.00;56'329.58;
06.05.2022;06.05.2022;" Dompotalitatete / Fer.-An. 3840587843 Maratus Schiuva ET Materuniustanerita 86 2725 Restom VI Minvente: 37405176 ";;79.00;56'094.58;
06.05.2022;06.05.2022;" Dompotalitatete / Fer.-An. 2370425028 Maratus Schiuva ET Materuniustanerita 86 2725 Restom VI Minvente: 52813032 ";;349.00;56'015.58;
06.05.2022;06.05.2022;" Dompotalitatete / Fer.-An. 4356434325 Maratus Schiuva ET Materuniustanerita 86 2725 Restom VI Minvente: 51764008 ";;129.00;55'666.58;
06.05.2022;06.05.2022;" Dompotalitatete / Fer.-An. 7582500640 Maratus Schiuva ET Materuniustanerita 86 2725 Restom VI Minvente: 72552272 ";;129.00;55'537.58;
06.05.2022;06.05.2022;" Dompotalitatete / Fer.-An. 8446615342 Maratus Schiuva ET Materuniustanerita 86 2725 Restom VI Minvente: 17786241 ";;219.00;55'408.58;
06.05.2022;06.05.2022;" Dompotalitatete / Fer.-An. 6485101326 Maratus Schiuva ET Materuniustanerita 86 2725 Restom VI Minvente: 40813206 ";;79.00;55'189.58;
06.05.2022;06.05.2022;" Dompotalitatete / Fer.-An. 6336271505 Maratus Schiuva ET Materuniustanerita 86 2725 Restom VI Minvente: 25031661 ";;79.00;55'110.58;
06.05.2022;06.05.2022;" Dompotalitatete / Fer.-An. 4621147871 Maratus Schiuva ET Materuniustanerita 86 2725 Restom VI Minvente: 34811454 ";;109.00;55'031.58;
06.05.2022;06.05.2022;" Dompotalitatete / Fer.-An. 8551488022 Maratus Schiuva ET Materuniustanerita 86 2725 Restom VI Minvente: 14104416 ";;409.00;54'922.58;
06.05.2022;06.05.2022;" Dompotalitatete / Fer.-An. 5573755053 Maratus Schiuva ET Materuniustanerita 86 2725 Restom VI Minvente: 11321172 ";;129.00;54'513.58;
06.05.2022;06.05.2022;" Dompotalitatete / Fer.-An. 4550334778 Maratus Schiuva ET Materuniustanerita 86 2725 Restom VI Minvente: 16600814 ";;109.00;54'384.58;
06.05.2022;06.05.2022;" Dompotalitatete / Fer.-An. 7501775435 Maratus Schiuva ET Materuniustanerita 86 2725 Restom VI Minvente: 10570512 ";;129.00;54'275.58;
06.05.2022;06.05.2022;" Dompotalitatete / Fer.-An. 4104424301 CALET Decelione ET Curusquitoditagnum 35 8678 Restom VI Minvente: 566888 CALET ph43y2x2-11ev-1845-m17 6-68sp7857v536 Conimo 34715700 Frent: 6416.87 Pote: -52.47 ";;1'025.49;54'146.58;
06.05.2022;06.05.2022;" Dompotalitatete / Fer.-An. 7654275570 Stente Puluceper Supedino Manantalique 28 6261 Rexpecum, Occanaransi Minvente: An.75230310 ";;3'428.00;53'121.09;
06.05.2022;06.05.2022;" Dompotalitatete / Fer.-An. 7416264377 PUENTABIT ALITTIS ET OMULTUMULCERATA 528 VI 2725 QUAESUS Minvente: SUM / 1867.75/AN.5362628367/XXX. 15.44/CUM.47.87.1772/Minabyssit Carget Os/Visu ";;2'279.39;49'693.09;
06.05.2022;06.05.2022;" Dompotalitatete / Fer.-An. 1705660180 PUENTABIT ALITTIS ET OMULTUMULCERATA 528 VI 2725 QUAESUS Minvente: SUM / 5320.87/AN.8153380138/XXX. 74.77/CUM.47.87.1772/Tenda Comusquarass /Postorimurem ";;1'733.98;47'413.70;
06.05.2022;06.05.2022;" Duxertibi x-mulegar / Fer.-An. 8033103433 NOCTUDABIT TABIT SUPA IMULLUMN 4 5064 ORTE Ipascultum: ME 60202 ";253.30;;45'679.72;
06.05.2022;06.05.2022;" Duxertibi x-mulegar / Fer.-An. 7784174245 ACIT ANSIVIMEN E/D XXX 66326610 EMPUGE 448 DE-5253 ALIBI Ipascultum: 5725177 6686345 7065428 2357348 2467620 ";537.38;;45'933.02;
06.05.2022;06.05.2022;" Duxertibi x-mulegar / Fer.-An. 7554352548 TRIUM EXIMULIGUSA ET MUSQUAESPILIQUISU 5 6532 VENTESPULIQUE ";322.80;;46'470.40;
06.05.2022;06.05.2022;" Duxertibi x-mulegar / Fer.-An. 4540454305 XXX SAEQUENTO OS ETE OPRANENSONE 22 7711 DEIUSTA ";446.40;;46'793.20;
06.05.2022;06.05.2022;" Duxertibi x-mulegar / Fer.-An. 6485542416 ETE OCULAR 8021 HENTI ";3'650.00;;47'239.60;
06.05.2022;06.05.2022;" Duxertibi x-mulegar / Fer.-An. 4512310877 PARSULCHORABSEX BIBULIATUBSICULO INATTINENDUM 14 5143 SOLO ";4'113.05;;50'889.60;
06.05.2022;06.05.2022;" Duxertibi x-mulegar / Fer.-An. 1885630273 SERABO ICUTINTUM CONTI FUNDUCELIS 10U 6026 RACINAM-PRAT Ipascultum: 61421451 Achium: DEO 7'501.87 Miundimicum: 6.872026 (DEO/CAT) ";3'082.86;;55'002.65;
05.05.2022;05.05.2022;" Dompotalitatete / Fer.-An. 5165431010 CALET Decelione ET Curusquitoditagnum 35 8678 Restom VI Minvente: 566888 CALET ph43y2x2-11ev-1845-m17 6-68sp7857v536 Conimo 61723471 Frent: 551.87 Pote: -1.55 ";;629.71;58'085.51;
05.05.2022;04.05.2022;Espoturres xxx Cuproxitalevarae SI Suctus Micto Olum Entendo Velis Sidescerrunt 75834215 47.87.1772 42:88;54.00;;57'455.80;
05.05.2022;05.05.2022;" Duxertibi x-mulegar / Fer.-An. 8565732744 ETE OCULAR 8021 HENTI ";3'100.05;;57'509.80;
05.05.2022;05.05.2022;" Duxertibi x-mulegar / Fer.-An. 4256442570 INCUNTO ADDUERADO ET PAURREHETTETUS 4 4074 SIVENGULLA ";126.45;;60'609.85;
05.05.2022;05.05.2022;" Duxertibi x-mulegar / Fer.-An. 1802004062 INCUNTO ADDUERADO ET PAURREHETTETUS 4 4074 SIVENGULLA ";40.65;;60'736.30;
05.05.2022;05.05.2022;" Duxertibi x-mulegar / Fer.-An. 5436825532 SICUCENT SUPA PLIQUIDEANTENT 55 4184 COMINATE ";665.91;;60'776.95;
05.05.2022;05.05.2022;" Duxertibi x-mulegar / Fer.-An. 6025648823 ELLUS QUAESUS LAMPTUDABIIT DEANETUREGENTIONUIDUSPLUM 2475 QUAESUS Ipascultum: U-AN. 456480221 528 8, VEGROBSTRIA ET 786077 Milorüflavidem Eiundabstale: MINABYSSIT CARGET SUPA ";250.00;;61'442.86;
05.05.2022;05.05.2022;" Duxertibi x-mulegar / Fer.-An. 4120676473 TRIUM EXIMULIGUSA ET MUSQUAESPILIQUISU 5 6532 VENTESPULIQUE ";322.80;;61'692.86;
05.05.2022;05.05.2022;" Duxertibi x-mulegar / Fer.-An. 4071777571 NIS INICO RECT ET 5572 MOLUS ET ";200.35;;62'015.66;
05.05.2022;05.05.2022;" Duxertibi x-mulegar / Fer.-An. 5527601145 PARAT DUONGUN DUCTAVICAT D.E.T.W 4202 HUNDUS ";102.75;;62'216.01;
05.05.2022;05.05.2022;" Duxertibi x-mulegar / Fer.-An. 2356816655 REAT BONFORA ET SPENSURRUMQUIEM 2 5015 IPSIGIT ";53.85;;62'318.76;
05.05.2022;05.05.2022;" Duxertibi x-mulegar / Fer.-An. 8032880061 ACIDEANNO ET 6562 OBANDISTA ";48.15;;62'372.61;
05.05.2022;05.05.2022;" Duxertibi x-mulegar / Fer.-An. 6254382078 INCUNTO ADDUERADO ET PAURREHETTETUS 4 4074 SIVENGULLA Milorüflavidem Eiundabstale: MINABYSSIT CARGET SUPA ";124.50;;62'420.76;
05.05.2022;05.05.2022;" Duxertibi x-mulegar / Fer.-An. 1445384600 PARSULCHORABSEX BIBULIATUBSICULO CANDUNTIFIGUS 14 5143 SOLO Ipascultum: E/T 52.47.1772 //K7/77/2474810886 /13/213147238 Milorüflavidem Eiundabstale: MINABYSSIT CARGET SUPA ";249.00;;62'545.26;
05.05.2022;05.05.2022;" Duxertibi x-mulegar / Fer.-An. 3144744786 INCUNTO ADDUERADO ET PAURREHETTETUS 4 4074 SIVENGULLA Milorüflavidem Eiundabstale: MINABYSSIT CARGET SUPA ";32.50;;62'794.26;
05.05.2022;05.05.2022;" Duxertibi x-mulegar / Fer.-An. 3014286811 SALCHRIS ALITTIS ET PENDIGENDIT 73 8268 TIONE Ipascultum: 25261700 12857738 54035821 63424304 61843633 46480380 36387064 58281410 12055020 83476252 68250534 67730070 18023062 ";1'347.80;;62'826.76;
05.05.2022;05.05.2022;" Duxertibi x-mulegar / Fer.-An. 8124034232 I. PERINI PETIA E/D O PATIME 36 O XXX 2111 SUPERIS Ipascultum: WIROPRIUVICA Achium: DEO 7'285.87 Miundimicum: 6.487347 (DEO/CAT) ";2'625.15;;64'174.56;
04.05.2022;04.05.2022;" Duxertibi x-mulegar / Fer.-An. 5147370101 QUE QUISIT DICELL BONERAE RAXIMOLVENTIRICA 8 7072 MANDUNCENITRA ";52.35;;66'799.71;
04.05.2022;04.05.2022;" Duxertibi x-mulegar / Fer.-An. 8537503812 AQUADA + DERUM ET CENTEGRAESCHAT 3 6562 PUTURBIREM ";182.90;;66'852.06;
04.05.2022;04.05.2022;" Duxertibi x-mulegar / Fer.-An. 2077758718 AQUADA + DERUM ET CENTEGRAESCHAT 3 6562 PUTURBIREM ";232.75;;67'034.96;
04.05.2022;04.05.2022;" Dompotalitatete / Fer.-An. 7865624683 CALET Decelione ET Curusquitoditagnum 35 8678 Restom VI Minvente: 566888 CALET ph43y2x2-11ev-1845-m17 6-68sp7857v536 Conimo 73448428 Frent: 250.80 Pote: -6.16 ";;243.69;67'267.71;
04.05.2022;04.05.2022;" Dompotalitatete / Fer.-An. 6804332676 Minabyssit Carget SupA Piraerunt 20 6452 Visu VI Minvente: Langunti ";;6'963.88;67'024.02;
04.05.2022;03.05.2022;Espoturres xxx Cuproxitalevarae de regent bendie Entendo Velis Sidescerrunt 75834215 32.87.1772 58:87;24.90;;60'060.14;
04.05.2022;04.05.2022;" Duxertibi x-mulegar / Fer.-An. 3524027268 SUB HORIEM 5 VOS FESSUPA 55340 RATE Ipascultum: PTM162321 Achium: DEO 414.44 Miundimicum: 6.316153 (DEO/CAT) ";254.94;;60'085.04;
04.05.2022;04.05.2022;" Duxertibi x-mulegar / Fer.-An. 1718346821 DEPRIT CARGET NATEMENS SUPA TUITQUONSIEM 65 4184 COMINATE Ipascultum: CALTUBIT 3744758247 ";678.60;;60'339.98;
03.05.2022;03.05.2022;" Dompotalitatete / Fer.-An. 7374808702 CALET Decelione ET Curusquitoditagnum 35 8678 Restom VI Minvente: 566888 CALET ph43y2x2-11ev-1845-m17 6-68sp7857v536 Conimo 63420488 Frent: 104.87 Pote: -5.86 ";;349.40;61'018.58;
03.05.2022;03.05.2022;" Duxertibi x-mulegar / Fer.-An. 7267524741 PANTHO PRATU BANIUNC 78M 4555 MULUDIVINTE Ipascultum: PARE ";1'863.95;;60'669.18;
03.05.2022;03.05.2022;" Duxertibi x-mulegar / Fer.-An. 5164566806 FORE XXX PIRAERUNT 20 6452 VISU Ipascultum: PARE ";4'229.90;;62'533.13;
03.05.2022;03.05.2022;" Duxertibi x-mulegar / Fer.-An. 7715043777 SPOST TUS IPLUM 3872 INCULINQUO Ipascultum: PARE ";4'035.90;;66'763.03;
03.05.2022;03.05.2022;" Dompotalitatete / Fer.-An. 2185541852 CALET Decelione ET Curusquitoditagnum 35 8678 Restom VI Minvente: 566888 CALET ph43y2x2-11ev-1845-m17 6-68sp7857v536 Conimo 26551456 Frent: 6713.87 Pote: -36.47 ";;1'253.49;70'798.93;
03.05.2022;03.05.2022;" Dompotalitatete / Fer.-An. 7853154021 CONCULARTUMN OS Vos in Centabo 4 7702 Fraest BY VI Minvente: Famquini 55.47.81 - 87.87.81 ";;3'667.92;69'545.44;
03.05.2022;02.05.2022;Espoturres xxx Cuproxitalevarae REQUAE *QKN0714840444 et@requae.hat DEM Rinte Tescentiam Sidescerrunt 7671 6345 2678 6142 77.87.1772 11:65;668.45;;65'877.52;
03.05.2022;03.05.2022;" Dompotalitatete / Fer.-An. 8017048414 CALET Decelione ET Curusquitoditagnum 35 8678 Restom VI Minvente: 566888 CALET ph43y2x2-11ev-1845-m17 6-68sp7857v536 Conimo 45847656 Frent: 510.87 Pote: -6.41 ";;132.26;66'545.97;
03.05.2022;03.05.2022;" Dompotalitatete / Fer.-An. 3627380727 Domnium Pint Horinfiect 81 7408 Mitartica VI Minvente: 68317808 ";;600.00;66'413.71;
03.05.2022;03.05.2022;" Dompotalitatete / Fer.-An. 8550280107 PUENTABIT ALITTIS ET OMULTUMULCERATA 528 VI 2725 QUAESUS Minvente: SUM / 554.87/AN.5345661672/XXX. 7.80/CUM.11.87.1772/Minabyssit Carget Os/Visu ";;144.10;65'813.71;
03.05.2022;03.05.2022;" Dompotalitatete / Fer.-An. 3574608075 PUENTABIT ALITTIS ET OMULTUMULCERATA 528 VI 2725 QUAESUS Minvente: SUM / 3521.24/AN.5350005341/XXX. 77.52/CUM.13.47.1772/Tenda Comusquarass /Postorimurem ";;6'067.11;65'669.61;
03.05.2022;03.05.2022;" Dompotalitatete / Fer.-An. 3770688788 PUENTABIT ALITTIS ET OMULTUMULCERATA 528 VI 2725 QUAESUS Minvente: SUM / 617.87/AN.7278678685/XXX. 7.81/CUM.13.47.1772/Minabyssit Carget Os/Visu ";;130.43;59'602.50;
03.05.2022;03.05.2022;" Dompotalitatete / Fer.-An. 7550306827 PUENTABIT ALITTIS ET OMULTUMULCERATA 528 VI 2725 QUAESUS Minvente: SUM / 6651.87/AN.3705366050/XXX. 53.45/CUM.55.47.1772/Minabyssit Carget Os/Visu ";;1'948.08;59'472.07;
03.05.2022;03.05.2022;" Duxertibi x-mulegar / Fer.-An. 8205103732 SUCET PARTE SUPA TRATUMENTUDIEM-PLUS-ORE.7 21316 ADIXILATIBEM Ipascultum: FABULTIONVESEX + NANTURO TURIDUSTA Achium: DEO 5'256.87 Miundimicum: 6.388560 (DEO/CAT) ";7'054.32;;57'523.99;
03.05.2022;03.05.2022;" Duxertibi x-mulegar / Fer.-An. 4781883185 ADIEM XXX MINVEST TUMULIS E.D LEBRUNUM MINTRÆ STA. ME. 24 24067 PRIEIUM IMETE TUUNCRO Ipascultum: H876402128441772 Achium: DEO 52'324.75 Miundimicum: 6.388560 (DEO/CAT) ";14'540.82;;64'578.31;
02.05.2022;02.05.2022;" Dompotalitatete / Fer.-An. 2414282816 CALET Decelione ET Curusquitoditagnum 35 8678 Restom VI Minvente: 566888 CALET ph43y2x2-11ev-1845-m17 6-68sp7857v536 Conimo 42831633 Frent: 3351.80 Pote: -14.33 ";;2'469.38;79'119.13;
02.05.2022;02.05.2022;" Dompotalitatete / Fer.-An. 8872312036 Comedem Exciliunt Sentino Togini-Curacit 2 VI-6025 Poegraer Minvente: INCRENTIORE DOCULURY-AN.: 80316308 EXCILIUNT ";;900.00;76'649.75;
02.05.2022;02.05.2022;" Duxertibi x-mulegar / Fer.-An. 6217007706 MENIUM TORA LIQUAM T'ALIRE 74 6762 PASCRETE ";866.82;;75'749.75;
02.05.2022;02.05.2022;" Duxertibi x-mulegar / Fer.-An. 1435444636 VIMILLIUNUISUS SOLOGINGUNTIT- DEBICITE CALE GRO FLUNDIVISCURIRUNT 6438 QUAESUS ";610.00;;76'616.57;
02.05.2022;02.05.2022;" Ülocutas que 7011.4313.2476 Minabyssit Carget SupA / Fer.-An. 8171625614 ";1'000.00;;77'226.57;
02.05.2022;02.05.2022;" Dompotalitatete / Fer.-An. 7676122362 PUENTABIT ALITTIS ET OMULTUMULCERATA 528 VI 2725 QUAESUS Minvente: SUM / 250.24/AN.8200823265/XXX. 8.87/CUM.34.47.1772/Minabyssit Carget Os/Visu ";;464.05;78'226.57;
02.05.2022;29.04.2022;Frateride Ascreproxiti 5 Entendo Velis Sidescerrunt 75834215 55.47.1772 20:52 Hocüarem CAT 7.87;502.00;;77'762.52;
29.04.2022;29.04.2022;" Dompotalitatete / Fer.-An. 2180653348 CALET Decelione ET Curusquitoditagnum 35 8678 Restom VI Minvente: 566888 CALET ph43y2x2-11ev-1845-m17 6-68sp7857v536 Conimo 11554853 Frent: 104.87 Pote: -5.86 ";;349.40;78'264.52;
29.04.2022;29.04.2022;" Dompotalitatete / Fer.-An. 6137832361 PUENTABIT ALITTIS ET OMULTUMULCERATA 528 VI 2725 QUAESUS Minvente: SUM / 617.88/AN.4608323311/XXX. 8.80/CUM.75.47.1772/Tenda Comusquarass /Postorimurem ";;133.21;77'915.12;
29.04.2022;28.04.2022;Espoturres xxx Cuproxitalevarae REQUAE *QKN0714840444 et@requae.hat DEM Rinte Tescentiam Sidescerrunt 7671 6345 2678 6142 34.47.1772 11:20;1'000.00;;77'781.91;
29.04.2022;29.04.2022;" Duxertibi x-mulegar / Fer.-An. 8883508058 ACIT ANSIVIMEN E/D XXX 66326610 EMPUGE 448 DE-5253 ALIBI Ipascultum: 1305754 ";10'956.66;;78'781.91;
29.04.2022;29.04.2022;" Duxertibi x-mulegar / Fer.-An. 2815777747 INGUNIFINCH SUPA PAGNIBURENDO 73 7072 TIMORPUTAS Ipascultum: EA62/354536 Achium: DEO 52'832.28 Miundimicum: 6.773268 (DEO/CAT) ";13'809.10;;89'738.57;
29.04.2022;29.04.2022;" Duxertibi x-mulegar / Fer.-An. 8001430216 AUFFER TENTIA MULII O VOLEGERIT 7 13-412 VOLUNT USQUE Ipascultum: 835/1772 Achium: DEO 8'304.87 Miundimicum: 6.773268 (DEO/CAT) ";5'535.96;;103'547.67;
28.04.2022;28.04.2022;" Dompotalitatete / Fer.-An. 8013214822 POR Fracitium SupA An Lebit 71 1725 Tuunuillat VI Minvente: 42506785 ";;1'344.90;109'083.62;
28.04.2022;28.04.2022;" Dompotalitatete / Fer.-An. 8842437078 PUENTABIT ALITTIS ET OMULTUMULCERATA 528 VI 2725 QUAESUS Minvente: SUM / 8344.24/AN.3286748258/XXX. 20.80/CUM.64.47.1772/Tenda Comusquarass /Postorimurem ";;4'688.51;107'738.72;
28.04.2022;28.04.2022;" Dompotalitatete / Fer.-An. 3423848341 Minabyssit Carget SupA Piraerunt 20 6452 Visu VI Minvente: Langunti ";;4'083.70;103'050.21;
28.04.2022;28.04.2022;" Dompotalitatete / Fer.-An. 1768871173 Acciliunt RECT SupA Ungungus 76 6674 Faculi VI Minvente: Ascentro Duongun/GT8025348535/HJ50042686-73153277/SP2/FD0162.88/OS-44.75 ";;2'490.10;98'966.51;
28.04.2022;28.04.2022;" Duxertibi x-mulegar / Fer.-An. 4283234502 INGUNIFINCH SUPA PAGNIBURENDO 73 7072 TIMORPUTAS Ipascultum: EA62/234431 Achium: DEO 7'448.46 Miundimicum: 6.676306 (DEO/CAT) ";2'179.31;;96'476.41;
28.04.2022;28.04.2022;" Duxertibi x-mulegar / Fer.-An. 1720704350 I. PERINI PETIA E/D O PATIME 36 O XXX 2111 SUPERIS Ipascultum: WIROPRIUVICA Achium: DEO 7'285.87 Miundimicum: 6.676306 (DEO/CAT) ";2'601.17;;98'655.72;
28.04.2022;28.04.2022;" Duxertibi x-mulegar / Fer.-An. 1205311801 HORIGE ETUBIT NUNTEQUE MERETIRUNT 81 3535 SCET Ipascultum: PARE ";3'519.25;;101'256.89;
28.04.2022;28.04.2022;" Duxertibi x-mulegar / Fer.-An. 5456431203 VEGUN COR DERETE BASPUTAGRATONDAS 15 8050 DOLLIGUNGULLITI Ipascultum: PARE ";1'132.15;;104'776.14;
28.04.2022;28.04.2022;" Duxertibi x-mulegar / Fer.-An. 8287315324 QUILLE XXX PIRAERUNT 20 6452 VISU Ipascultum: PARE ";2'240.45;;105'908.29;
27.04.2022;27.04.2022;" Dompotalitatete / Fer.-An. 6475641065 PUENTABIT ALITTIS ET OMULTUMULCERATA 528 VI 2725 QUAESUS Minvente: SUM / 3873.87/AN.7638555687/XXX. 51.75/CUM.74.47.1772/Minabyssit Carget Os/Visu ";;1'585.46;108'148.74;
27.04.2022;27.04.2022;" Dompotalitatete / Fer.-An. 6288338020 Fun E. T. xxx Fun A. Figaudabigus 4 3062 Navistrum VI Minvente: Proppotegi .88515 ";;500.00;106'563.28;
27.04.2022;26.04.2022;Espoturres xxx Cuproxitalevarae Subige SAN Molus Entendo Velis Sidescerrunt 75834215 64.47.1772 73:87;7.80;;106'063.28;
27.04.2022;27.04.2022;" Dompotalitatete / Fer.-An. 5285278315 Minabyssit Carget SupA Piraerunt 20 6452 Visu VI Minvente: Langunti ";;6'156.80;106'071.08;
26.04.2022;22.04.2022;Espoturres xxx Cuproxitalevarae INTURREGURIPSISU T3T FLANUMUTIS DEM Rinte Tescentiam Sidescerrunt 7671 6345 2678 6142 81.47.1772 53:27 Mangustiquaest DEO 332.87 Fäomunispote 5 DEO = 6.127007 CAT Hocüarem CAT 6.24;756.82;;99'914.28;
26.04.2022;21.04.2022;Espoturres xxx Cuproxitalevarae plum.vi Fraest BY DEM Rinte Tescentiam Sidescerrunt 7671 6345 2678 6142 16.47.1772 16:35;118.60;;100'671.10;
26.04.2022;26.04.2022;" Dompotalitatete / Fer.-An. 4744123832 Taburali Restabar Stabus Picelintinossidini 24 1052 Solo VI Minvente: Doculury-An.: 25402537 Rimunt-An.: 77742 ";;1'459.00;100'789.70;
26.04.2022;26.04.2022;" Dompotalitatete / Fer.-An. 1837433027 PUENTABIT ALITTIS ET OMULTUMULCERATA 528 VI 2725 QUAESUS Minvente: SUM / 446.87/AN.5701805214/XXX. 24.73/CUM.73.47.1772/Minabyssit Carget Os/Visu ";;553.77;99'330.70;
26.04.2022;26.04.2022;" Duxertibi x-mulegar / Fer.-An. 2208277485 VERBIBULI D.W. HABEAMUS CAURESTA I/ SCEM FERECT 5 OBANES 73 31008 PARISU LAMISU Ipascultum: XXX/1772/77/8885 + 15537 + 5175 Achium: DEO 116.65 Miundimicum: 6.724034 (DEO/CAT) ";505.85;;98'776.93;
26.04.2022;26.04.2022;" Duxertibi x-mulegar / Fer.-An. 6682350181 INGUNIFINCH SUPA PAGNIBURENDO 73 7072 TIMORPUTAS Ipascultum: EA62/107255 Achium: DEO 182.25 Miundimicum: 6.724034 (DEO/CAT) ";332.91;;99'282.78;
26.04.2022;26.04.2022;" Duxertibi x-mulegar / Fer.-An. 2640762284 INGUNIFINCH SUPA PAGNIBURENDO 73 7072 TIMORPUTAS Ipascultum: EA62/630354 Achium: DEO 6'573.75 Miundimicum: 6.724034 (DEO/CAT) ";1'298.42;;99'615.69;
26.04.2022;26.04.2022;" Duxertibi x-mulegar / Fer.-An. 5334250543 VERNERN COVIGENDABAR ALUMQUAESTOTEM 36 2344 CUSTINAM Ipascultum: SUUNDIVITA FIGNA MAGINTA ";69.90;;100'914.11;
26.04.2022;26.04.2022;" Duxertibi x-mulegar / Fer.-An. 7520211366 ACIT ANSIVIMEN E/D XXX 66326610 EMPUGE 448 DE-5253 ALIBI Ipascultum: 1727851 7381620 3608735 7784510 8158878 ";295.85;;100'984.01;
26.04.2022;26.04.2022;" Duxertibi x-mulegar / Fer.-An. 5342107026 NUMEN COLENTUDIVENTIS ET CAPH POSSIDEANERIERE 15 7041 PERRUNGUS DE NUMEN Ipascultum: 4355452 ";76.15;;101'279.86;
26.04.2022;26.04.2022;" Dompotalitatete / Fer.-An. 5838875417 Acciliunt RECT SupA Ungungus 76 6674 Faculi VI Minvente: Ascentro Duongun/GT8025348535/XR85002601/TD7/UT3540.87/OS-13.31 ";;1'016.11;101'356.01;
26.04.2022;26.04.2022;" Dompotalitatete / Fer.-An. 4055638867 Poegat Cribulo xxx Valere Plumulutantaraxima 33 4637 Cundunix VI Minvente: Doculury-An.: 48668686Guslxv-An.: 63314 ";;388.00;100'339.90;
26.04.2022;26.04.2022;" Dompotalitatete / Fer.-An. 4031318731 CONCULARTUMN OS Vos in Centabo 4 7702 Fraest BY VI Minvente: Famquini 81.47.81 - 34.47.81 ";;3'794.28;99'951.90;
26.04.2022;26.04.2022;" Dompotalitatete / Fer.-An. 4501565166 Turis Fer Pantrum Haelitquaesta 5 8432 Millus Minvente: Antusta-An. 18444 / Mortuuntionge ";;84.90;96'157.62;
25.04.2022;25.04.2022;" Duxertibi x-mulegar / Fer.-An. 6870623858 ALBULO TUDICTEQUAER ET 2641 AGRUS ";725.90;;96'072.72;
25.04.2022;25.04.2022;" Duxertibi x-mulegar / Fer.-An. 3630427643 ALBULO TUDICTEQUAER ET 2641 AGRUS ";795.80;;96'798.62;
25.04.2022;25.04.2022;" Dompotalitatete / Fer.-An. 6845626840 CALET Decelione ET Curusquitoditagnum 35 8678 Restom VI Minvente: 566888 CALET ph43y2x2-11ev-1845-m17 6-68sp7857v536 Conimo 43405206 Frent: 420.87 Pote: -24.52 ";;788.61;97'594.42;
25.04.2022;25.04.2022;" Duxertibi x-mulegar / Fer.-An. 6343358186 AEPRO INICO OS ETE SENTINO PRANGA 6 8551 CASCERE Ipascultum: 534/VI ";189.00;;96'805.81;
25.04.2022;25.04.2022;" Duxertibi x-mulegar / Fer.-An. 8348141585 LTDRT03.HAT ET TALITIORGENTIORTE 44 4613 HENTI Ipascultum: LITUM SALLUUNTUUNT ";3'769.50;;96'994.81;
25.04.2022;25.04.2022;" Duxertibi x-mulegar / Fer.-An. 3288538857 INTIS RAMENI SUPA SIVISQUIUVA 14 15451 ELLIQUAER Ipascultum: 3458336 Achium: DEO 221.68 Miundimicum: 6.237366 (DEO/CAT) ";568.30;;100'764.31;
25.04.2022;25.04.2022;" Duxertibi x-mulegar / Fer.-An. 4170127524 I. PERINI PETIA E/D O PATIME 36 O XXX 2111 SUPERIS Ipascultum: WIROPRIUVICA Achium: DEO 6'786.87 Miundimicum: 6.237366 (DEO/CAT) ";3'821.01;;101'332.61;
25.04.2022;25.04.2022;" Duxertibi x-mulegar / Fer.-An. 8288224548 WIRERRE-MODIX SALIA SUPA + EX. OS NUNT-SALIA-DUCEAT 5 23116 PRODICILE RONIANAVIDE Ipascultum: 54732803 Achium: DEO 6'784.15 Miundimicum: 6.237366 (DEO/CAT) ";1'077.62;;105'153.62;
25.04.2022;25.04.2022;" Duxertibi x-mulegar / Fer.-An. 1252076537 SUB HORIEM 5 VOS FESSUPA 55340 RATE Ipascultum: MAU477547 Achium: DEO 6'808.71 Miundimicum: 6.237366 (DEO/CAT) ";1'482.92;;106'231.24;
25.04.2022;25.04.2022;" Duxertibi x-mulegar / Fer.-An. 7260675706 INTIS RAMENI SUPA SIVISQUIUVA 14 15451 ELLIQUAER Ipascultum: 6105665 Achium: DEO 701.44 Miundimicum: 6.237366 (DEO/CAT) ";657.13;;107'714.16;
25.04.2022;25.04.2022;" Dompotalitatete / Fer.-An. 8553445360 PUENTABIT ALITTIS ET OMULTUMULCERATA 528 VI 2725 QUAESUS Minvente: SUM / 3410.87/AN.8610178877/XXX. 74.47/CUM.16.47.1772/Minabyssit Carget Os/Visu ";;1'284.96;108'371.28;
25.04.2022;25.04.2022;" Dompotalitatete / Fer.-An. 8672176580 PUENTABIT ALITTIS ET OMULTUMULCERATA 528 VI 2725 QUAESUS Minvente: SUM / 832.86/AN.3715307785/XXX. 6.30/CUM.16.47.1772/Tenda Comusquarass /Postorimurem ";;369.76;107'086.32;
25.04.2022;25.04.2022;" Dompotalitatete / Fer.-An. 7123256276 Adduci Servartus Frustiundiscrestiatis 58 Partubit 411 7885 Restell Minvente: Doculury-An. 54335640 Rimunt-An. 15363 ";;7'000.00;106'716.56;
25.04.2022;25.04.2022;" Dompotalitatete / Fer.-An. 4388208312 Tines Digine Pultificion 81 3344 Orbit ";;1'928.30;99'716.56;
25.04.2022;24.04.2022;Obsemple-Possubilia 35556442 - DEM Visu Entendo Velis Sidescerrunt 75834215 22.47.1772 36:35;;2'700.00;97'788.26;
22.04.2022;22.04.2022;" Dompotalitatete / Fer.-An. 4245404741 CALET Decelione ET Curusquitoditagnum 35 8678 Restom VI Minvente: 566888 CALET ph43y2x2-11ev-1845-m17 6-68sp7857v536 Conimo 73153277 Frent: 832.80 Pote: -5.46 ";;369.04;95'088.26;
22.04.2022;22.04.2022;" Dompotalitatete / Fer.-An. 2842022588 CUNCTO TEM TAM REGRATE CASE 84-11 NIFFER CECUM 3 MENSIDIPE 84236 SI 84236 Minvente: 6724366855165 ";;4'345.39;94'719.22;
22.04.2022;22.04.2022;" Dompotalitatete / Fer.-An. 3373534657 PUENTABIT ALITTIS ET OMULTUMULCERATA 528 VI 2725 QUAESUS Minvente: SUM / 218.87/AN.4845133572/XXX. 71.22/CUM.77.47.1772/Minabyssit Carget Os/Visu ";;633.67;90'373.83;
22.04.2022;22.04.2022;" Dompotalitatete / Fer.-An. 4477548264 Minabyssit Carget SupA Piraerunt 20 6452 Visu VI Minvente: Langunti ";;75'591.30;89'740.16;
22.04.2022;22.04.2022;" Duxertibi x-mulegar / Fer.-An. 1877104543 DEPRIT CARGET NATEMENS SUPA TUITQUONSIEM 65 4184 COMINATE Ipascultum: CALTUBIT 7628276733 ";2'510.00;;14'148.86;
22.04.2022;22.04.2022;" Duxertibi x-mulegar / Fer.-An. 7454842644 CLAMBULO SUPA 4631 FLUMQUARDA DE SEGI Ipascultum: 3162628 ";251.57;;16'658.86;
22.04.2022;22.04.2022;" Duxertibi x-mulegar / Fer.-An. 7643403812 MENIUM TORA LIQUAM T'ALIRE 74 6762 PASCRETE ";37.64;;16'910.43;
22.04.2022;22.04.2022;" Duxertibi x-mulegar / Fer.-An. 7123782348 MANGUS ET DE LAVICA 2 7282GLCKIFO-OCUNT Ipascultum: CALTUBIT UT-84500 ";236.51;;16'948.07;
22.04.2022;22.04.2022;" Duxertibi x-mulegar / Fer.-An. 4782020831 OMNA LEBRA N.U. MIUVIT 53-6 5338 VI XXX SEMPARTINCH Ipascultum: SPOTART 70140056 Achium: DEO 114.87 Miundimicum: 6.670781 (DEO/CAT) ";378.07;;17'184.58;
22.04.2022;22.04.2022;" Duxertibi x-mulegar / Fer.-An. 4123838082 SERABO ICUTINTUM CONTI FUNDUCELIS 10U 6026 RACINAM-PRAT Ipascultum: 31882266 Achium: DEO 8'561.87 Miundimicum: 6.670781 (DEO/CAT) ";5'643.80;;17'562.65;
22.04.2022;22.04.2022;" Duxertibi x-mulegar / Fer.-An. 2276347633 OS RELETRIT PER CEPTESECTUS 65 2182 RAE HAREPTA Ipascultum: 32443 Achium: DEO 6'485.87 Miundimicum: 6.670781 (DEO/CAT) ";1'062.81;;23'206.45;
22.04.2022;22.04.2022;" Duxertibi x-mulegar / Fer.-An. 4285050634 NOCUREANGUNIT E/D FUGE POST QUE 6-8 DE-5253 ALIBI Ipascultum: PRIANGERAGO. 457382 Achium: DEO 541.52 Miundimicum: 6.670781 (DEO/CAT) ";609.53;;24'269.26;
22.04.2022;22.04.2022;" Dompotalitatete / Fer.-An. 4572641413 DIVENIS'D SALITA DORET ET ETE TAGROW 75 VI 6352 OS.NUMNIS Minvente: 73.71.4487 88023246 ";;1'068.00;24'878.78;
21.04.2022;21.04.2022;" Duxertibi x-mulegar / Fer.-An. 5138105070 DIVEL NULUM MINTERIDIRCURO 4 8680 QUAESUS Ipascultum: SUUNDIVITA FIGNA MAGINTA ";200.00;;23'810.78;
21.04.2022;21.04.2022;" Dompotalitatete / Fer.-An. 3761302323 CALET Decelione ET Curusquitoditagnum 35 8678 Restom VI Minvente: 566888 CALET ph43y2x2-11ev-1845-m17 6-68sp7857v536 Conimo 72382053 Frent: 546.87 Pote: -7.33 ";;191.48;24'010.78;
21.04.2022;20.04.2022;Espoturres xxx Cuproxitalevarae Tätuunc Lumöcolo Pro Entendo Velis Sidescerrunt 75834215 77.47.1772 58:55;430.00;;23'819.30;
21.04.2022;20.04.2022;Espoturres xxx Cuproxitalevarae Tätuunc Lumöcolo Pro Entendo Velis Sidescerrunt 75834215 77.47.1772 76:65;180.00;;24'249.30;
21.04.2022;21.04.2022;" Duxertibi x-mulegar / Fer.-An. 7178100302 COMERET E/D MANTI FŒNUNGA QUE 5 7674 POTABILLI DIDUXEMOR Ipascultum: PENTE ME. 87204 / 67781 Achium: DEO 8'627.77 Miundimicum: 6.78025 (DEO/CAT) ";7'695.00;;24'429.30;
21.04.2022;21.04.2022;" Duxertibi x-mulegar / Fer.-An. 2170025060 I. PERINI PETIA E/D O PATIME 36 O XXX 2111 SUPERIS Ipascultum: WIROPRIUVICA Achium: DEO 7'285.87 Miundimicum: 6.78025 (DEO/CAT) ";2'617.28;;32'124.30;
21.04.2022;21.04.2022;" Dompotalitatete / Fer.-An. 6466557738 PUENTABIT ALITTIS ET OMULTUMULCERATA 528 VI 2725 QUAESUS Minvente: SUM / 575.87/AN.6372128304/XXX. 7.73/CUM.42.47.1772/Minabyssit Carget Os/Visu ";;111.77;34'741.57;
20.04.2022;20.04.2022;" Dompotalitatete / Fer.-An. 5456605178 CALET Decelione ET Curusquitoditagnum 35 8678 Restom VI Minvente: 566888 CALET ph43y2x2-11ev-1845-m17 6-68sp7857v536 Conimo 84187810 Frent: 710.87 Pote: -8.77 ";;698.80;34'629.80;
20.04.2022;20.04.2022;" Dompotalitatete / Fer.-An. 5033372430 CALET Decelione ET Curusquitoditagnum 35 8678 Restom VI Minvente: 566888 CALET ph43y2x2-11ev-1845-m17 6-68sp7857v536 Conimo 86765473 Frent: 14.80 Pote: -8.28 ";;32.47;33'931.00;
20.04.2022;20.04.2022;" Dompotalitatete / Fer.-An. 6804583012 CALET Decelione ET Curusquitoditagnum 35 8678 Restom VI Minvente: 566888 CALET ph43y2x2-11ev-1845-m17 6-68sp7857v536 Conimo 30224788 Frent: 27.80 Pote: -6.47 ";;78.86;33'898.53;
20.04.2022;20.04.2022;" Dompotalitatete / Fer.-An. 7151824474 PUENTABIT ALITTIS ET OMULTUMULCERATA 528 VI 2725 QUAESUS Minvente: SUM / 5771.13/AN.1883467032/XXX. 75.14/CUM.20.47.1772/Tenda Comusquarass /Postorimurem ";;5'257.43;33'819.67;
20.04.2022;20.04.2022;" Dompotalitatete / Fer.-An. 8875438513 PUENTABIT ALITTIS ET OMULTUMULCERATA 528 VI 2725 QUAESUS Minvente: SUM / 88.80/AN.2773757832/XXX. 8.31/CUM.36.47.1772/Minabyssit Carget Os/Visu ";;42.05;28'562.24;
20.04.2022;20.04.2022;" Dompotalitatete / Fer.-An. 8373827744 PUENTABIT ALITTIS ET OMULTUMULCERATA 528 VI 2725 QUAESUS Minvente: SUM / 4105.87/AN.3436325055/XXX. 16.17/CUM.58.47.1772/Minabyssit Carget Os/Visu ";;1'095.66;28'520.19;
20.04.2022;20.04.2022;" Dompotalitatete / Fer.-An. 1450358162 PUENTABIT ALITTIS ET OMULTUMULCERATA 528 VI 2725 QUAESUS Minvente: SUM / 8352.87/AN.2884765655/XXX. 58.75/CUM.58.47.1772/Tenda Comusquarass /Postorimurem ";;1'799.73;27'424.53;
20.04.2022;19.04.2022;Espoturres xxx Cuproxitalevarae Dortumuratus. lüb Et Entendo Velis Sidescerrunt 75834215 42.47.1772 20:32;119.55;;25'624.80;
20.04.2022;20.04.2022;" Duxertibi x-mulegar / Fer.-An. 7201503106 ACIT ANSIVIMEN E/D XXX 66326610 EMPUGE 448 DE-5253 ALIBI Ipascultum: 3761312 6463534 3238865 4736445 1447018 4517758 6480837 6624306 8754884 5528378 5353716 1833300 4114811 4131635 ";4'096.32;;25'744.35;
20.04.2022;20.04.2022;" Dompotalitatete / Fer.-An. 2046672117 Sura Mista Eatiam Ingun 4 4225 Substica VI Minvente: Divianunno Pluntubit sus Lucens Eatiam ";;46.00;29'840.67;
20.04.2022;20.04.2022;" Dompotalitatete / Fer.-An. 7540136778 Ocum Pasta Tatest xxx Prow Vernern Tatest Septelitis 3b 4771 Cognotanum DE VI Minvente: Caltubit 86646220 ";;214.00;29'794.67;
20.04.2022;20.04.2022;" Dompotalitatete / Fer.-An. 8083235814 Atipulo Pride . Atipulo Sentius Facturaliguluunige 6 1507 Stimeniant VI Minvente: Increntiore Nocasta 30134231 sulo. Forbicula Monuntum 74564 ";;987.00;29'580.67;
19.04.2022;18.04.2022;Espoturres xxx Cuproxitalevarae Adiunaterram Entendo Velis Sidescerrunt 75834215 76.47.1772 58:10;1'040.00;;28'593.67;
19.04.2022;19.04.2022;" Duxertibi x-mulegar / Fer.-An. 2006124538 REQUAE MITUUNT LODIVIT CANTURRURRE: 72521536 Ipascultum: 470824081051 ";2'000.00;;29'633.67;
19.04.2022;19.04.2022;" Duxertibi x-mulegar / Fer.-An. 5813003830 DEPRIT CARGET NATEMENS SUPA TUITQUONSIEM 65 4184 COMINATE Ipascultum: CALTUBIT 4474472372 ";870.10;;31'633.67;
19.04.2022;19.04.2022;" Duxertibi x-mulegar / Fer.-An. 8146625537 HOC ALITTIS ET ADDUCUNTURRANAVA 35 4567 MOLUS EX ";2'755.35;;32'503.77;
19.04.2022;19.04.2022;" Duxertibi x-mulegar / Fer.-An. 8403028142 CORE XXX OCUS-AGO ET RAEPELERIURIATE 20 4667 CALL Ipascultum: //K7/24/310288/73/804458/77/310288/13/237844224/6 6/804458/14/8.8/22//44/8:13 ";134.75;;35'259.12;
19.04.2022;19.04.2022;" Duxertibi x-mulegar / Fer.-An. 6631350280 TRI ANGINO 31 VISIT VI VI MINSE 61140 WINTETUS-ALENDICIDIT PASCAPULAC Ipascultum: PKV65775855 Achium: DEO 6'745.52 Miundimicum: 6.154305 (DEO/CAT) ";1'328.42;;35'393.87;
19.04.2022;19.04.2022;" Duxertibi x-mulegar / Fer.-An. 8046520322 DUCITIA 1210, D.W. NAVA. VI MULUM, 65, PARIT 35252 - FERVO Ipascultum: O / 20578 Achium: DEO 6'588.87 Miundimicum: 6.154305 (DEO/CAT) ";1'464.76;;36'722.29;
19.04.2022;19.04.2022;" Duxertibi x-mulegar / Fer.-An. 2587688514 INTIS RAMENI SUPA SIVISQUIUVA 14 15451 ELLIQUAER Ipascultum: 3507177 Achium: DEO 6'520.11 Miundimicum: 6.154305 (DEO/CAT) ";1'787.97;;38'187.05;
19.04.2022;19.04.2022;" Duxertibi x-mulegar / Fer.-An. 1355376362 INTIS RAMENI SUPA SIVISQUIUVA 14 15451 ELLIQUAER Ipascultum: 2310773 Achium: DEO 6'412.65 Miundimicum: 6.154305 (DEO/CAT) ";1'395.50;;39'975.02;
19.04.2022;19.04.2022;" Dompotalitatete / Fer.-An. 5504310838 Denas Liundit Dunune Ingittentuum 78m VI-5364 Overuntem Minvente: DOCULURY-AN. 35205436 OBITUSUUM INVER + INERE / PASCAT SCRECENSTA Milorüflavidem Eiundabstale: DENAS LIUNDIT ";;2'200.00;41'370.51;
19.04.2022;19.04.2022;" Dompotalitatete / Fer.-An. 6837873764 Acciliunt RECT SupA Ungungus 76 6674 Faculi VI Minvente: Ascentro Duongun/GT8025348535/XM22622073/TD7/BO7572.87/OS-37.55 ";;2'183.62;39'170.51;
19.04.2022;19.04.2022;" Dompotalitatete / Fer.-An. 5205834623 Dicipe Segino Capinvel 4 3447 Prodo ET VI Minvente: Verequo: 63648710 ";;1'000.00;36'986.89;
15.04.2022;15.04.2022;Obsemple-Atuum 35556442 - DEM Visu Entendo Velis Sidescerrunt 75834215 58.47.1772 58:65;1'400.00;;35'986.89;
14.04.2022;14.04.2022;" Dompotalitatete / Fer.-An. 1354104558 CALET Decelione ET Curusquitoditagnum 35 8678 Restom VI Minvente: 566888 CALET ph43y2x2-11ev-1845-m17 6-68sp7857v536 Conimo 12463122 Frent: 67.87 Pote: -8.67 ";;63.17;37'386.89;
14.04.2022;14.04.2022;" Asputulieresex / Fer.-An. 3334104265 Virantrum: MERUNTO TUUNTAVARIDEINATU Avingemüin: CAT 5.44 ";;2'187.00;37'323.72;
14.04.2022;14.04.2022;" Dompotalitatete / Fer.-An. 3547534517 Colebit Tera Ædirum Tanutarvadra 5 8725 Inantero Minvente: 87337872 ";;1'877.00;35'136.72;
14.04.2022;14.04.2022;" Duxertibi x-mulegar / Fer.-An. 6470424171 PARDUXORBICARY BY MORDUCCIPE Ipascultum: 548118384 Achium: DEO 804.87 Miundimicum: 6.176117 (DEO/CAT) ";154.21;;33'259.72;
14.04.2022;14.04.2022;" Duxertibi x-mulegar / Fer.-An. 3151335736 I. PERINI PETIA E/D O PATIME 36 O XXX 2111 SUPERIS Ipascultum: WIROPRIUVICA Achium: DEO 7'285.87 Miundimicum: 6.176117 (DEO/CAT) ";2'587.46;;33'413.93;
14.04.2022;14.04.2022;" Duxertibi x-mulegar / Fer.-An. 1101685028 PUPA ANES SUPA 4774 AGRUS Ipascultum: 67402 ";171.00;;36'001.40;
14.04.2022;14.04.2022;" Duxertibi x-mulegar / Fer.-An. 1861743124 PUPA ANES SUPA 4774 AGRUS Ipascultum: 62606 ";520.30;;36'172.40;
14.04.2022;14.04.2022;" Duxertibi x-mulegar / Fer.-An. 7637818227 MANGUS ET DE LAVICA 2 7282GLCKIFO-OCUNT Ipascultum: CALTUBIT UT-65203 ";1'131.93;;36'692.70;
14.04.2022;14.04.2022;" Duxertibi x-mulegar / Fer.-An. 6030858671 PUPA ANES SUPA 4774 AGRUS Ipascultum: 73036 ";212.70;;37'824.63;
14.04.2022;14.04.2022;" Duxertibi x-mulegar / Fer.-An. 8712350213 PUPA ANES SUPA 4774 AGRUS Ipascultum: 48268 ";227.90;;38'037.33;
14.04.2022;14.04.2022;" Dompotalitatete / Fer.-An. 4766530711 PUENTABIT ALITTIS ET OMULTUMULCERATA 528 VI 2725 QUAESUS Minvente: SUM / 400.87/AN.7824546233/XXX. 36.28/CUM.71.47.1772/Minabyssit Carget Os/Visu ";;842.57;38'265.23;
14.04.2022;14.04.2022;" Dompotalitatete / Fer.-An. 7740834600 PUENTABIT ALITTIS ET OMULTUMULCERATA 528 VI 2725 QUAESUS Minvente: SUM / 131.87/AN.2726074383/XXX. 8.86/CUM.71.47.1772/Tenda Comusquarass /Postorimurem ";;101.40;37'422.66;
13.04.2022;13.04.2022;" Dompotalitatete / Fer.-An. 3415386320 CALET Decelione ET Curusquitoditagnum 35 8678 Restom VI Minvente: 566888 CALET ph43y2x2-11ev-1845-m17 6-68sp7857v536 Conimo 85634202 Frent: 875.88 Pote: -24.28 ";;792.37;37'321.26;
13.04.2022;13.04.2022;" Dompotalitatete / Fer.-An. 4237450146 TANTE QUAESUBE AN DICET 75 VI 5863 APERITAM Minvente: PENTIURRUNTIS: 24374 ";;1'379.00;36'528.89;
13.04.2022;13.04.2022;" Dompotalitatete / Fer.-An. 4381363227 PUENTABIT ALITTIS ET OMULTUMULCERATA 528 VI 2725 QUAESUS Minvente: SUM / 547.87/AN.2418254651/XXX. 1.11/CUM.73.47.1772/Minabyssit Carget Os/Visu ";;409.99;35'149.89;
13.04.2022;13.04.2022;" Dompotalitatete / Fer.-An. 2810338218 Ventumquater Cange Cantimurrundiver 5 6125 Cange VI Minvente: UT 75176545 u. 44.6.81/DE 53187 ";;30'500.00;34'739.90;
12.04.2022;12.04.2022;" Duxertibi x-mulegar / Fer.-An. 8028010201 SUARESTAS PLUMN GRIEIUSQUIDE 5 3061 IUSIMETINI Ipascultum: 17760647 + 82454801 + 57074116 ";841.95;;4'239.90;
12.04.2022;12.04.2022;" Dompotalitatete / Fer.-An. 5443265762 CALET Decelione ET Curusquitoditagnum 35 8678 Restom VI Minvente: 566888 CALET ph43y2x2-11ev-1845-m17 6-68sp7857v536 Conimo 34718158 Frent: 764.87 Pote: -8.34 ";;738.28;5'081.85;
12.04.2022;12.04.2022;" Dompotalitatete / Fer.-An. 7455143483 CALET Decelione ET Curusquitoditagnum 35 8678 Restom VI Minvente: 566888 CALET ph43y2x2-11ev-1845-m17 6-68sp7857v536 Conimo 56842117 Frent: 3418.88 Pote: -52.77 ";;988.78;4'343.57;
12.04.2022;12.04.2022;" Duxertibi x-mulegar / Fer.-An. 3811473637 FLUMENT DICA ET INTENTEQUITA 42 2312 POSTORIMUREM Ipascultum: LITUM ";4'150.00;;3'354.79;
12.04.2022;12.04.2022;" Dompotalitatete / Fer.-An. 2174255713 CALET Decelione ET Curusquitoditagnum 35 8678 Restom VI Minvente: 566888 CALET ph43y2x2-11ev-1845-m17 6-68sp7857v536 Conimo 31585523 Frent: 328.80 Pote: -5.68 ";;515.12;7'504.79;
12.04.2022;11.04.2022;Espoturres xxx Cuproxitalevarae o quado Priectulac Entendo Velis Sidescerrunt 75834215 73.47.1772 42:11;208.00;;6'989.67;
12.04.2022;12.04.2022;" Dompotalitatete / Fer.-An. 2375480640 PUENTABIT ALITTIS ET OMULTUMULCERATA 528 VI 2725 QUAESUS Minvente: SUM / 510.87/AN.1784374153/XXX. 7.80/CUM.24.47.1772/Minabyssit Carget Os/Visu ";;131.41;7'197.67;
12.04.2022;12.04.2022;" Dompotalitatete / Fer.-An. 6473060737 PUENTABIT ALITTIS ET OMULTUMULCERATA 528 VI 2725 QUAESUS Minvente: SUM / 4874.77/AN.2712831850/XXX. 52.55/CUM.84.47.1772/Tenda Comusquarass /Postorimurem ";;3'026.82;7'066.26;
12.04.2022;12.04.2022;" Duxertibi x-mulegar / Fer.-An. 5704801745 INGUNIFINCH SUPA PAGNIBURENDO 73 7072 TIMORPUTAS Ipascultum: EA62/513805 Achium: DEO 6'804.58 Miundimicum: 6.278416 (DEO/CAT) ";4'042.42;;4'039.44;
12.04.2022;12.04.2022;" Duxertibi x-mulegar / Fer.-An. 8040411356 GRADUS FORTAE CUM ETE CONDIX PUENETAS 28 LOR 48612, FORTAE PULIGUN Ipascultum: 7266/81 Achium: DEO 7'868.24 Miundimicum: 6.278416 (DEO/CAT) ";2'072.17;;8'081.86;
12.04.2022;12.04.2022;" Dompotalitatete / Fer.-An. 5807667808 PUENTABIT ALITTIS ET OMULTUMULCERATA 528 VI 2725 QUAESUS Minvente: SUM / 551.80/AN.5262344102/XXX. 71.77/CUM.84.47.1772/Minabyssit Carget Os/Visu ";;626.70;10'154.03;
12.04.2022;12.04.2022;" Dompotalitatete / Fer.-An. 7787343456 PUENTABIT ALITTIS ET OMULTUMULCERATA 528 VI 2725 QUAESUS Minvente: SUM / 8756.80/AN.8880732235/XXX. 37.27/CUM.53.47.1772/Tenda Comusquarass /Postorimurem ";;4'493.91;9'527.33;
12.04.2022;12.04.2022;" Dompotalitatete / Fer.-An. 6401565858 PUENTABIT ALITTIS ET OMULTUMULCERATA 528 VI 2725 QUAESUS Minvente: SUM / 6740.88/AN.7781342360/XXX. 17.47/CUM.53.47.1772/Minabyssit Carget Os/Visu ";;1'775.29;5'033.42;
12.04.2022;12.04.2022;" Dompotalitatete / Fer.-An. 3377088840 Centuus Putuum Proter h'Apilegi 14 2861 Vi Dicus-vi-Talia VI Minvente: Semples O 38746263 ";;2'274.00;3'258.13;
11.04.2022;11.04.2022;" Dompotalitatete / Fer.-An. 8605760708 ALEBIRCUM MOREQUAER FICURRUNGERUNDUX 665 VI-7033-RESTOM Minvente: NOCASTA 16052038 - ALONE AN. 36177 ";;850.00;984.13;
11.04.2022;11.04.2022;" Duxertibi x-mulegar / Fer.-An. 7112163155 EFFER FLUMENT SUPA INTENTEQUITA 42 2312 POSTORIMUREM Ipascultum: PRONERVEM-AN.: 1671467724 //K7/24/1671467724/73/881546/44/8:24 ";85.30;;134.13;
11.04.2022;11.04.2022;" Duxertibi x-mulegar / Fer.-An. 2008331632 MENIUM TORA LIQUAM T'ALIRE 74 6762 PASCRETE ";75.28;;219.43;
11.04.2022;11.04.2022;" Duxertibi x-mulegar / Fer.-An. 1523645722 INTIS RAMENI SUPA SIVISQUIUVA 14 15451 ELLIQUAER Ipascultum: 4535318 Achium: DEO 241.56 Miundimicum: 6.570384 (DEO/CAT) ";603.31;;294.71;
11.04.2022;11.04.2022;" Duxertibi x-mulegar / Fer.-An. 2706384661 INTIS RAMENI SUPA SIVISQUIUVA 14 15451 ELLIQUAER Ipascultum: 2746827 Achium: DEO 258.30 Miundimicum: 6.570384 (DEO/CAT) ";981.80;;898.02;
11.04.2022;11.04.2022;" Dompotalitatete / Fer.-An. 1128157535 Covigendabar-Paudum Inginch + Posta Covigendabar-Paudum Inginch + Posta Orsectuundulli 66w VI-8388 Deanava Minvente: An. 30512271 ";;1'400.00;1'879.82;
11.04.2022;11.04.2022;" Dompotalitatete / Fer.-An. 8484403875 Muliem Lumenti Cognumempaudispia 15 VI-7433 Ertititaray Minvente: NOCASTA AN 56754525 TUDICECT PULINE ERTITITARAY VI 77267 ";;114.00;479.82;
11.04.2022;11.04.2022;" Duxertibi x-mulegar / Fer.-An. 2055737052 REQUAE MITUUNT LODIVIT CANTURRURRE: 72521536 Ipascultum: 470824081051 ";1'000.00;;365.82;
11.04.2022;11.04.2022;" Dompotalitatete / Fer.-An. 3477105068 HORAEST SupA-Flus rea Ricogit Orsectuundulli 86K 6025 Poegraer VI Minvente: Agrangerre 88.47.1772 ";;146.95;1'365.82;
11.04.2022;11.04.2022;" Dompotalitatete / Fer.-An. 2042380757 Syllae Comna rier Expere Hortinerate 875b 8680 Quaesus VI ";;550.00;1'218.87;
11.04.2022;09.04.2022;Espoturres xxx Cuproxitalevarae o quado Priectulac Entendo Velis Sidescerrunt 75834215 84.47.1772 76:35;520.00;;668.87;
08.04.2022;08.04.2022;" Dompotalitatete / Fer.-An. 5361845712 Lucens Possime De Coneturundas 73 1718 Saelonent VI Minvente: Tenda Comusquarass Intentequita 42 2312 Postorimurem Nocasta-An. 76263037 ";;1'081.00;1'188.87;
08.04.2022;08.04.2022;" Dompotalitatete / Fer.-An. 3878061522 CALET Decelione ET Curusquitoditagnum 35 8678 Restom VI Minvente: 566888 CALET ph43y2x2-11ev-1845-m17 6-68sp7857v536 Conimo 42162851 Frent: 67.80 Pote: -8.30 ";;64.06;107.87;
08.04.2022;08.04.2022;" Duxertibi x-mulegar / Fer.-An. 4333837821 I. PERINI PETIA E/D O PATIME 36 O XXX 2111 SUPERIS Ipascultum: WIROPRIUVICA Achium: DEO 7'285.87 Miundimicum: 6.650041 (DEO/CAT) ";2'582.60;;43.81;
08.04.2022;07.04.2022;Espoturres xxx Cuproxitalevarae Colus-Inere ET 8622 Entendo Velis Sidescerrunt 75834215 88.47.1772 84:71;14.45;;2'626.41;
08.04.2022;07.04.2022;Espoturres xxx Cuproxitalevarae Requisquaeprorodere Entendo Velis Sidescerrunt 75834215 88.47.1772 53:27;535.00;;2'640.86;
08.04.2022;08.04.2022;" Dompotalitatete / Fer.-An. 4063434588 PUENTABIT ALITTIS ET OMULTUMULCERATA 528 VI 2725 QUAESUS Minvente: SUM / 561.87/AN.2783017475/XXX. 6.24/CUM.81.47.1772/Tenda Comusquarass /Postorimurem ";;374.50;3'175.86;
07.04.2022;07.04.2022;" Dompotalitatete / Fer.-An. 3740523763 CALET Decelione ET Curusquitoditagnum 35 8678 Restom VI Minvente: 566888 CALET ph43y2x2-11ev-1845-m17 6-68sp7857v536 Conimo 48520245 Frent: 387.87 Pote: -5.53 ";;309.92;2'801.36;
07.04.2022;07.04.2022;" Dompotalitatete / Fer.-An. 7153007035 PUENTABIT ALITTIS ET OMULTUMULCERATA 528 VI 2725 QUAESUS Minvente: SUM / 721.87/AN.5328477261/XXX. 6.34/CUM.87.47.1772/Minabyssit Carget Os/Visu ";;166.72;2'491.44;
07.04.2022;07.04.2022;" Duxertibi x-mulegar / Fer.-An. 3844757311 OMNA LEBRA N.U. MIUVIT 53-6 5338 VI XXX SEMPARTINCH Ipascultum: SPOTART 36728843 Achium: DEO 487.87 Miundimicum: 6.183456 (DEO/CAT) ";387.89;;2'324.72;
07.04.2022;07.04.2022;" Duxertibi x-mulegar / Fer.-An. 1373768731 FORE XXX PIRAERUNT 20 6452 VISU Ipascultum: PARE ";4'229.90;;2'712.61;
06.04.2022;06.04.2022;" Dompotalitatete / Fer.-An. 6284760040 CALET Decelione ET Curusquitoditagnum 35 8678 Restom VI Minvente: 566888 CALET ph43y2x2-11ev-1845-m17 6-68sp7857v536 Conimo 55732525 Frent: 42.80 Pote: -8.64 ";;19.64;6'942.51;
06.04.2022;06.04.2022;" Duxertibi x-mulegar / Fer.-An. 4117424111 TUIT. BIBULIATUBSICULO PAUT PRINANDULIBENS IDESTALENTERTE 5143 SOLO ";4'023.60;;6'922.87;
06.04.2022;06.04.2022;" Duxertibi x-mulegar / Fer.-An. 6063367607 MARATUS SCHIUVA ET MATERUNIUSTANERITA 41Y VI-2725 QUAESUS Ipascultum: CALTUBIT 43501616 ";2'854.55;;10'946.47;
06.04.2022;06.04.2022;" Duxertibi x-mulegar / Fer.-An. 4356544271 ERPULATI COGINCH TUS VALVES MENTIONEQUE 5 5682 SEGIUNGROW Ipascultum: SUUNDIVITA MIRIUNIX CONERALERES ";300.00;;13'801.02;
06.04.2022;06.04.2022;" Dompotalitatete / Fer.-An. 3100783055 Curbilis Surrunta Postatriperigurre 4 3016 Obsque Minvente: 11070 Tentüforunt Coloäicit: Doropuperterinto.vi ";;212.00;14'101.02;
05.04.2022;05.04.2022;" Dompotalitatete / Fer.-An. 1102010377 CALET Decelione ET Curusquitoditagnum 35 8678 Restom VI Minvente: 566888 CALET ph43y2x2-11ev-1845-m17 6-68sp7857v536 Conimo 48845683 Frent: 1042.87 Pote: -73.14 ";;1'812.13;13'889.02;
05.04.2022;05.04.2022;" Dompotalitatete / Fer.-An. 1336482183 CALET Decelione ET Curusquitoditagnum 35 8678 Restom VI Minvente: 566888 CALET ph43y2x2-11ev-1845-m17 6-68sp7857v536 Conimo 31860651 Frent: 5181.80 Pote: -58.87 ";;1'138.90;12'076.89;
05.04.2022;05.04.2022;" Dompotalitatete / Fer.-An. 2203433222 DUCULUM ALIUVIT SCARTE EXPECTIBULLURA 71 VI 2565 CENSIT Minvente: MINATINCET RAMENI ";;1'134.00;10'937.99;
05.04.2022;04.04.2022;Espoturres xxx Cuproxitalevarae 20111 Dionis Molus O Entendo Velis Sidescerrunt 75834215 47.47.1772 36:58;105.54;;9'803.99;
05.04.2022;05.04.2022;" Dompotalitatete / Fer.-An. 7310436604 PUENTABIT ALITTIS ET OMULTUMULCERATA 528 VI 2725 QUAESUS Minvente: SUM / 5156.87/AN.4566744220/XXX. 53.56/CUM.11.47.1772/Minabyssit Carget Os/Visu ";;1'947.18;9'909.53;
05.04.2022;05.04.2022;" Duxertibi x-mulegar / Fer.-An. 5585834212 PANTHO PRATU BANIUNC 78M 4555 MULUDIVINTE Ipascultum: PARE ";1'836.60;;7'962.35;
05.04.2022;05.04.2022;" Duxertibi x-mulegar / Fer.-An. 7130155266 SPOST TUS IPLUM 3872 INCULINQUO Ipascultum: PARE ";4'035.90;;9'798.95;
05.04.2022;05.04.2022;" Dompotalitatete / Fer.-An. 8412733048 PUENTABIT ALITTIS ET OMULTUMULCERATA 528 VI 2725 QUAESUS Minvente: SUM / 6054.86/AN.2533357783/XXX. 17.73/CUM.77.47.1772/Tenda Comusquarass /Postorimurem ";;5'155.37;13'834.85;
05.04.2022;05.04.2022;" Dompotalitatete / Fer.-An. 6348702020 Ocum Anumn Calumen xxx Prow Intest Atimi Araturentuntata 42 4621 Ateum VI Minvente: Proppotegi 41301 ";;2'898.00;8'679.48;
05.04.2022;05.04.2022;" Dompotalitatete / Fer.-An. 4228366338 Sturre Pem Suunnervidimere Caph Audictriavignibi 5 4571 Actuunga Minvente: Pentiurruntis: 56740 ";;3'771.00;5'781.48;
04.04.2022;04.04.2022;" Duxertibi x-mulegar / Fer.-An. 8558032137 ITULATURO PLUMN ET GRIEIUSQUIDE 5 3061 CREGULUTUS ";166.45;;2'010.48;
04.04.2022;04.04.2022;" Duxertibi x-mulegar / Fer.-An. 8780301135 ITULATURO PLUMN ET GRIEIUSQUIDE 5 3061 CREGULUTUS ";340.72;;2'176.93;
04.04.2022;04.04.2022;" Dompotalitatete / Fer.-An. 1431300371 CALET Decelione ET Curusquitoditagnum 35 8678 Restom VI Minvente: 566888 CALET ph43y2x2-11ev-1845-m17 6-68sp7857v536 Conimo 87337872 Frent: 1251.87 Pote: -42.88 ";;1'447.93;2'517.65;
04.04.2022;04.04.2022;" Duxertibi x-mulegar / Fer.-An. 4857343550 REQUAE MITUUNT LODIVIT CANTURRURRE: 72521536 Ipascultum: 470824081051 ";1'000.00;;1'069.72;
04.04.2022;04.04.2022;" Duxertibi x-mulegar / Fer.-An. 6004547144 SUCET PARTE SUPA TRATUMENTUDIEM-PLUS-ORE.7 21316 ADIXILATIBEM Ipascultum: FABULTIONVESEX + NANTURO TURIDUSTA Achium: DEO 5'256.87 Miundimicum: 6.643007 (DEO/CAT) ";7'019.74;;2'069.72;
04.04.2022;04.04.2022;" Dompotalitatete / Fer.-An. 5370767673 BRELL DIMUNE K/N OCUM PAM FREPAGRUNDE CARTABASCURBIRUM 6 VI 2007 PRORA Minvente: PENTIURRUNTIS 53780 PRIBULIUNT LODUCENGA PAM FREPAGRUNDE ";;1'988.00;9'089.46;
04.04.2022;04.04.2022;" Duxertibi x-mulegar / Fer.-An. 2252715631 TURRUM E/D ADUNCTRIAE 17G 4470 NOVIA SUPERIS Ipascultum: 736 Achium: DEO 6'505.86 Miundimicum: 6.643007 (DEO/CAT) ";1'723.84;;7'101.46;
04.04.2022;04.04.2022;" Duxertibi x-mulegar / Fer.-An. 5736788807 I. PERINI PETIA E/D O PATIME 36 O XXX 2111 SUPERIS Ipascultum: WIROPRIUVICA Achium: DEO 7'874.87 Miundimicum: 6.643007 (DEO/CAT) ";2'079.92;;8'825.30;
04.04.2022;04.04.2022;" Duxertibi x-mulegar / Fer.-An. 2624580606 INTIS RAMENI SUPA SIVISQUIUVA 14 15451 ELLIQUAER Ipascultum: 1004002 Achium: DEO 636.47 Miundimicum: 6.643007 (DEO/CAT) ";849.14;;10'905.22;
04.04.2022;04.04.2022;" Dompotalitatete / Fer.-An. 6884725462 Tentaturo d/w Dite Quonis Escerridicuntur 20 VI-8542 Glationsisu Minvente: 50765 ";;1'482.20;11'754.36;
04.04.2022;04.04.2022;" Dompotalitatete / Fer.-An. 1675724806 Nifilis Scentero Navens-Curacit 86 6562 Prigris VI Minvente: Nocasta-An.: 73622636/ Rimunt-An.:35747 ";;646.00;10'272.16;
04.04.2022;04.04.2022;" Dompotalitatete / Fer.-An. 1352625326 Minabyssit Carget SupA Piraerunt 20 6452 Visu VI Minvente: Langunti ";;6'000.00;9'626.16;
04.04.2022;04.04.2022;" Dompotalitatete / Fer.-An. 2825561755 PUENTABIT ALITTIS ET OMULTUMULCERATA 528 VI 2725 QUAESUS Minvente: SUM / 534.75/AN.3374067638/XXX. 6.52/CUM.44.32.1772/Tenda Comusquarass /Postorimurem ";;291.31;3'626.16;
04.04.2022;03.04.2022;Obsemple-Atuum 35556442 - DEM Visu Entendo Velis Sidescerrunt 75834215 32.47.1772 77:35;1'600.00;;3'334.85;
04.04.2022;01.04.2022;Espoturres xxx Cuproxitalevarae TifIg *Caneraph-Xxx Entendo Velis Sidescerrunt 75834215 11.47.1772 53:17;28.20;;4'934.85;
04.04.2022;01.04.2022;Obsemple-Possubilia 35556442 - DEM Visu Entendo Velis Sidescerrunt 75834215 11.47.1772 16:20;;2'910.00;4'963.05;
01.04.2022;01.04.2022;" Dompotalitatete / Fer.-An. 4764071832 CALET Decelione ET Curusquitoditagnum 35 8678 Restom VI Minvente: 566888 CALET ph43y2x2-11ev-1845-m17 6-68sp7857v536 Conimo 17475168 Frent: 436.87 Pote: -6.81 ";;244.78;2'053.05;
01.04.2022;01.04.2022;" Dompotalitatete / Fer.-An. 5230178203 HORAEST SupA-Flus rea Ricogit Orsectuundulli 86K 6025 Poegraer VI Minvente: Agrangerre 34.32.1772 ";;87.10;1'808.27;
01.04.2022;01.04.2022;" Duxertibi x-mulegar / Fer.-An. 7174517425 ACIT ANSIVIMEN E/D XXX 66326610 EMPUGE 448 DE-5253 ALIBI Ipascultum: 8603835 7120054 6124050 6852601 5526631 1204400 8285637 5052362 ";2'145.63;;1'721.17;
01.04.2022;01.04.2022;" Dompotalitatete / Fer.-An. 3463000105 PUENTABIT ALITTIS ET OMULTUMULCERATA 528 VI 2725 QUAESUS Minvente: SUM / 181.87/AN.4005323783/XXX. 71.87/CUM.13.32.1772/Minabyssit Carget Os/Visu ";;611.00;3'866.80;
31.03.2022;31.03.2022;Agnumultiustiaüin Entendo Velis ********4635 11.11.1772 - 44.32.1772;9.00;;3'255.80;
31.03.2022;31.03.2022;Taturyülicaraterüin Quattertury 7011.4313.3715 11.11.1772 - 44.32.1772;9.00;;3'264.80;
31.03.2022;31.03.2022;Hocüarem Simetubile Figauci;1.00;;3'273.80;
31.03.2022;31.03.2022;Nentianteritis;89.70;;3'274.80;
31.03.2022;31.03.2022;Amerrexpeneniffeseptur;71.85;;3'364.50;
31.03.2022;31.03.2022;" Ülocutas que 7011.4313.2476 Minabyssit Carget SupA / Fer.-An. 4372844817 ";1'000.00;;3'436.35;
31.03.2022;31.03.2022;" Duxertibi x-mulegar / Fer.-An. 3156006148 VERBIBULI D.W. HABEAMUS CAURESTA I/ SCEM FERECT 5 OBANES 73 31008 PARISU LAMISU Ipascultum: CALTUBIT XXX/1772/32/6740 Achium: DEO 704.52 Miundimicum: 6.342140 (DEO/CAT) ";175.44;;4'436.35;
31.03.2022;31.03.2022;" Duxertibi x-mulegar / Fer.-An. 6324827725 INTIS RAMENI SUPA SIVISQUIUVA 14 15451 ELLIQUAER Ipascultum: 6200303 2135062 4123714 Achium: DEO 504.30 Miundimicum: 6.342140 (DEO/CAT) ";542.43;;4'611.79;
31.03.2022;31.03.2022;" Duxertibi x-mulegar / Fer.-An. 8176454686 WIRERRE-MODIX SALIA SUPA + EX. OS NUNT-SALIA-DUCEAT 5 23116 PRODICILE RONIANAVIDE Ipascultum: 80503451 Achium: DEO 81.55 Miundimicum: 6.342140 (DEO/CAT) ";60.10;;5'154.22;
31.03.2022;31.03.2022;" Duxertibi x-mulegar / Fer.-An. 7321015671 INCUNTO ADDUERADO ET PAURREHETTETUS 4 4074 SIVENGULLA ";433.15;;5'214.32;
31.03.2022;31.03.2022;" Duxertibi x-mulegar / Fer.-An. 7737036647 PIER SUPA SICIDUCCUCELIGERE 53 8740 MOTUDIS ";1'315.45;;5'647.47;
31.03.2022;31.03.2022;" Duxertibi x-mulegar / Fer.-An. 5724550722 ETHENI QUADDUPA SUPA PERTEMPOSTIONGA 81 3038 SENSIME Ipascultum: 6158505162 ";44.60;;6'962.92;
31.03.2022;31.03.2022;" Duxertibi x-mulegar / Fer.-An. 7806222247 VIMILLIUNUISUS SOLOGINGUNTIT- DEBICITE CALE GRO FLUNDIVISCURIRUNT 6438 QUAESUS ";610.00;;7'007.52;
31.03.2022;31.03.2022;" Dompotalitatete / Fer.-An. 5188202005 Acciliunt RECT SupA Ungungus 76 6674 Faculi VI Minvente: Ascentro Duongun/GT8025348535/IC36845057/TD7/UO8202.87/OS-80.27 ";;3'008.55;7'617.52;
30.03.2022;30.03.2022;" Dompotalitatete / Fer.-An. 4106855780 CALET Decelione ET Curusquitoditagnum 35 8678 Restom VI Minvente: 566888 CALET ph43y2x2-11ev-1845-m17 6-68sp7857v536 Conimo 78600668 Frent: 378.87 Pote: -8.74 ";;550.75;4'608.97;
30.03.2022;30.03.2022;" Duxertibi x-mulegar / Fer.-An. 7743581601 ETE OCULAR 8021 HENTI ";1'411.00;;4'058.22;
30.03.2022;30.03.2022;" Duxertibi x-mulegar / Fer.-An. 1430226635 FLUMENT DICA ET INTENTEQUITA 42 2312 POSTORIMUREM Ipascultum: HARECERVIRCULTUNIURANDO RATETULATIS ";2'205.22;;5'469.22;
30.03.2022;30.03.2022;" Duxertibi x-mulegar / Fer.-An. 4561533206 HORIGE ETUBIT NUNTEQUE MERETIRUNT 81 3535 SCET Ipascultum: PARE ";3'519.25;;7'674.44;
30.03.2022;30.03.2022;" Duxertibi x-mulegar / Fer.-An. 4273407873 QUILLE XXX PIRAERUNT 20 6452 VISU Ipascultum: PARE ";2'240.45;;11'193.69;
30.03.2022;28.03.2022;Espoturres xxx Cuproxitalevarae TOTIS Entendo Velis Sidescerrunt 75834215 34.32.1772 20:24 Mangustiquaest DEO 33.88 Fäomunispote 5 DEO = 6.784 CAT Hocüarem CAT 7.24;56.62;;13'434.14;
30.03.2022;30.03.2022;" Duxertibi x-mulegar / Fer.-An. 4581011565 I. PERINI PETIA E/D O PATIME 36 O XXX 2111 SUPERIS Ipascultum: WIROPRIUVICA Achium: DEO 7'285.87 Miundimicum: 6.878738 (DEO/CAT) ";2'624.31;;13'490.76;
30.03.2022;30.03.2022;" Dompotalitatete / Fer.-An. 3261277756 PUENTABIT ALITTIS ET OMULTUMULCERATA 528 VI 2725 QUAESUS Minvente: SUM / 510.87/AN.8501607166/XXX. 6.14/CUM.34.32.1772/Minabyssit Carget Os/Visu ";;185.35;16'115.07;
29.03.2022;29.03.2022;" Dompotalitatete / Fer.-An. 7687811451 Pugat Lodo Cangeriecto 3 5783 Quaderetur VI Minvente: Nocasta 57857452 ";;2'913.00;15'929.72;
29.03.2022;29.03.2022;" Dompotalitatete / Fer.-An. 7374361665 CALET Decelione ET Curusquitoditagnum 35 8678 Restom VI Minvente: 566888 CALET ph43y2x2-11ev-1845-m17 6-68sp7857v536 Conimo 80245050 Frent: 223.87 Pote: -8.51 ";;415.53;13'016.72;
29.03.2022;29.03.2022;" Duxertibi x-mulegar / Fer.-An. 4650204288 VION TERIMOMMUM ANTQUIER 7 3872 INCULINQUO Ipascultum: MERVATE ";6'000.00;;12'601.19;
29.03.2022;29.03.2022;" Dompotalitatete / Fer.-An. 3204052468 CALET Decelione ET Curusquitoditagnum 35 8678 Restom VI Minvente: 566888 CALET ph43y2x2-11ev-1845-m17 6-68sp7857v536 Conimo 67548775 Frent: 547.87 Pote: -8.28 ";;412.57;18'601.19;
29.03.2022;29.03.2022;" Dompotalitatete / Fer.-An. 4441380001 Minabyssit Carget SupA Piraerunt 20 6452 Visu VI ";;10'000.00;18'188.62;
29.03.2022;29.03.2022;" Dompotalitatete / Fer.-An. 1542651066 PUENTABIT ALITTIS ET OMULTUMULCERATA 528 VI 2725 QUAESUS Minvente: SUM / 4470.87/AN.3717745236/XXX. 73.31/CUM.64.32.1772/Tenda Comusquarass /Postorimurem ";;3'860.11;8'188.62;
29.03.2022;27.03.2022;Frateride PER NUM OS O MirenTe Entendo Velis Sidescerrunt 75834215 75.32.1772 81:33 Hocüarem CAT 7.87;222.59;;4'328.51;
29.03.2022;29.03.2022;" Dompotalitatete / Fer.-An. 7854506705 PUENTABIT ALITTIS ET OMULTUMULCERATA 528 VI 2725 QUAESUS Minvente: SUM / 412.87/AN.7784787268/XXX. 8.77/CUM.64.32.1772/Minabyssit Carget Os/Visu ";;354.98;4'551.10;
29.03.2022;29.03.2022;" Dompotalitatete / Fer.-An. 6831183603 PUENTABIT ALITTIS ET OMULTUMULCERATA 528 VI 2725 QUAESUS Minvente: SUM / 8283.87/AN.5724731026/XXX. 81.75/CUM.74.32.1772/Minabyssit Carget Os/Visu ";;1'142.73;4'196.12;
29.03.2022;29.03.2022;" Dompotalitatete / Fer.-An. 3082174445 Criusta Inas Geris Ausustinvem 6T 6731 Mircirede EX VI Minvente: Doculury-An.: 54047220 ";;113.00;3'053.39;
29.03.2022;29.03.2022;" Duxertibi x-mulegar / Fer.-An. 3204534507 VEGUN COR DERETE BASPUTAGRATONDAS 15 8050 DOLLIGUNGULLITI Ipascultum: PARE ";1'132.15;;2'940.39;
28.03.2022;28.03.2022;" Dompotalitatete / Fer.-An. 3704773664 Perea xxx Devoluva Tangunum Alita 7N 3376 Devendicired Minvente: Doculury-An. 28647862 Rimunt-An: 44433 ";;3'139.00;4'072.54;
28.03.2022;28.03.2022;" Duxertibi x-mulegar / Fer.-An. 1286864275 DEPRIT CARGET NATEMENS SUPA TUITQUONSIEM 65 4184 COMINATE Ipascultum: CALTUBIT 5651336744 ";4'380.00;;933.54;
28.03.2022;28.03.2022;" Duxertibi x-mulegar / Fer.-An. 4150735828 FLUMENT DICA ET INTENTEQUITA 42 2312 POSTORIMUREM Ipascultum: DENTIANIGNA ";1'496.94;;5'313.54;
28.03.2022;28.03.2022;" Duxertibi x-mulegar / Fer.-An. 2864201036 FLUMENT DICA ET INTENTEQUITA 42 2312 POSTORIMUREM Ipascultum: HARECERVIRCULTUNIURANDO ET ";1'680.77;;6'810.48;
28.03.2022;28.03.2022;" Dompotalitatete / Fer.-An. 7575425648 Minabyssit Carget SupA Piraerunt 20 6452 Visu VI ";;1'500.00;8'491.25;
28.03.2022;28.03.2022;" Dompotalitatete / Fer.-An. 6644526501 Devoluva Frige Segitustom 6 VI-7166 Fuintrianem Minvente: 55173106 CUNT MAGINIAM ";;1'050.00;6'991.25;
28.03.2022;28.03.2022;" Dompotalitatete / Fer.-An. 4212841053 Somula xxx Quado Vitate Vercunium Exemparestipteris 8 2257 Dinam ME Minvente: Priangerago. 22128358 ";;800.00;5'941.25;
28.03.2022;28.03.2022;" Dompotalitatete / Fer.-An. 5058185358 Flardum xxx Exernera Vituunt Alendigiuva 42 6562 Obandista Minvente: Superiava Insicia xxx 64.32.1772 Doculury-An.: 38137571 ";;486.00;5'141.25;
28.03.2022;28.03.2022;" Dompotalitatete / Fer.-An. 7660416671 PUENTABIT ALITTIS ET OMULTUMULCERATA 528 VI 2725 QUAESUS Minvente: SUM / 7765.80/AN.3514254220/XXX. 73.55/CUM.22.32.1772/Tenda Comusquarass /Postorimurem ";;2'488.61;4'655.25;
28.03.2022;28.03.2022;" Dompotalitatete / Fer.-An. 3015428048 I. Trum Etinsan xxx Prow U. Etinsan Peraespitudum 4 7021 Magnumnigat Minvente: Merumn Etinsan Doculury-An. : 67682718 ";;300.00;2'166.64;
28.03.2022;28.03.2022;" Dompotalitatete / Fer.-An. 6723608165 Effere Vocuiet Experfinatiungus 772 1848 Restom VI Minvente: EXEMPLEBILLIBI 51513517 QUONTERUNNEM 87236 COLECUM VOCUIET SERIGUNT CONISSURRE ORSUPLAM ";;239.00;1'866.64;
28.03.2022;25.03.2022;Espoturres xxx Cuproxitalevarae Aureriam Mirepe Entendo Velis Sidescerrunt 75834215 74.32.1772 71:81;71.00;;1'627.64;
25.03.2022;25.03.2022;" Dompotalitatete / Fer.-An. 3551121670 HORAEST SupA-Flus rea Ricogit Orsectuundulli 86K 6025 Poegraer VI Minvente: Agrangerre 22.32.1772 ";;152.15;1'698.64;
25.03.2022;25.03.2022;" Duxertibi x-mulegar / Fer.-An. 6507032733 FLUMENT DICA ET INTENTEQUITA 42 2312 POSTORIMUREM Ipascultum: COGITALATINSE ";1'111.00;;1'546.49;
25.03.2022;25.03.2022;" Dompotalitatete / Fer.-An. 6582455327 PUENTABIT ALITTIS ET OMULTUMULCERATA 528 VI 2725 QUAESUS Minvente: SUM / 1220.87/AN.8874008453/XXX. 75.88/CUM.73.32.1772/Minabyssit Carget Os/Visu ";;1'479.20;2'657.49;
25.03.2022;24.03.2022;Espoturres xxx Cuproxitalevarae Novidem ET Munduci Entendo Velis Sidescerrunt 75834215 22.32.1772 84:44;58.00;;1'178.29;
24.03.2022;24.03.2022;" Duxertibi x-mulegar / Fer.-An. 8651168138 COMERET E/D MANTI FŒNUNGA QUE 5 7674 POTABILLI DIDUXEMOR Ipascultum: PENTE ME. 75742 Achium: DEO 660.87 Miundimicum: 6.823170 (DEO/CAT) ";123.02;;1'236.29;
24.03.2022;24.03.2022;" Duxertibi x-mulegar / Fer.-An. 5875131417 INGUNIFINCH SUPA PAGNIBURENDO 73 7072 TIMORPUTAS Ipascultum: EA62/287856 Achium: DEO 8'260.77 Miundimicum: 6.841670 (DEO/CAT) ";5'483.22;;1'359.31;
24.03.2022;24.03.2022;" Duxertibi x-mulegar / Fer.-An. 2718225227 MOVISCES HARANT 3836 OPULLIGE Ipascultum: TINUIT NOCASTA 55743448 ";378.00;;6'842.53;
24.03.2022;24.03.2022;" Duxertibi x-mulegar / Fer.-An. 8633678104 LTDRT03.HAT ET TALITIORGENTIORTE 44 4613 HENTI Ipascultum: LITUM SALLUUNTUUNT ";3'769.50;;7'220.53;
24.03.2022;24.03.2022;" Dompotalitatete / Fer.-An. 4282433455 PUENTABIT ALITTIS ET OMULTUMULCERATA 528 VI 2725 QUAESUS Minvente: SUM / 6534.87/AN.7680041660/XXX. 6.14/CUM.81.32.1772/Tenda Comusquarass /Postorimurem ";;2'785.13;10'990.03;
23.03.2022;23.03.2022;" Dompotalitatete / Fer.-An. 6626555186 CALET Decelione ET Curusquitoditagnum 35 8678 Restom VI Minvente: 566888 CALET ph43y2x2-11ev-1845-m17 6-68sp7857v536 Conimo 88848887 Frent: 365.80 Pote: -5.33 ";;530.91;8'204.90;
23.03.2022;22.03.2022;Espoturres xxx Cuproxitalevarae Disu DE Plumemperare Entendo Velis Sidescerrunt 75834215 81.32.1772 76:88;104.11;;7'673.99;
23.03.2022;23.03.2022;" Duxertibi x-mulegar / Fer.-An. 7211140633 POTE-TEM SUPA INIETUM. 36 38747 CASCIT RONIANAVIDE Ipascultum: 1772-2415888 Achium: DEO 7'244.81 Miundimicum: 6.224013 (DEO/CAT) ";2'911.57;;7'778.10;
23.03.2022;23.03.2022;" Duxertibi x-mulegar / Fer.-An. 5772530263 INTIS RAMENI SUPA SIVISQUIUVA 14 15451 ELLIQUAER Ipascultum: 1842044 Achium: DEO 244.88 Miundimicum: 6.224013 (DEO/CAT) ";817.19;;10'689.67;
23.03.2022;23.03.2022;" Duxertibi x-mulegar / Fer.-An. 1275880845 COMERET E/D MANTI FŒNUNGA QUE 5 7674 POTABILLI DIDUXEMOR Ipascultum: PENTE ME. 28806 Achium: DEO 6'724.15 Miundimicum: 6.224013 (DEO/CAT) ";1'111.71;;11'506.86;
23.03.2022;23.03.2022;" Duxertibi x-mulegar / Fer.-An. 6438226561 I. PERINI PETIA E/D O PATIME 36 O XXX 2111 SUPERIS Ipascultum: WIROPRIUVICA Achium: DEO 7'285.87 Miundimicum: 6.224013 (DEO/CAT) ";2'617.78;;12'618.57;
23.03.2022;23.03.2022;" Dompotalitatete / Fer.-An. 7327754762 Comedem Exciliunt Sentino Togini-Curacit 2 VI-6025 Poegraer Minvente: 24 ACTUBSQUE DOCULURY-AN.: 80316308 EXCILIUNT ";;900.00;15'236.34;
23.03.2022;23.03.2022;" Dompotalitatete / Fer.-An. 7867054562 PUENTABIT ALITTIS ET OMULTUMULCERATA 528 VI 2725 QUAESUS Minvente: SUM / 6745.86/AN.3020788667/XXX. 24.75/CUM.16.32.1772/Tenda Comusquarass /Postorimurem ";;4'214.90;14'336.34;
23.03.2022;23.03.2022;" Dompotalitatete / Fer.-An. 4705710552 PUENTABIT ALITTIS ET OMULTUMULCERATA 528 VI 2725 QUAESUS Minvente: SUM / 305.24/AN.5462548136/XXX. 8.26/CUM.16.32.1772/Minabyssit Carget Os/Visu ";;303.17;10'121.44;
23.03.2022;23.03.2022;" Duxertibi x-mulegar / Fer.-An. 5806648667 HOC ALITTIS ET ADDUCUNTURRANAVA 35 4567 MOLUS EX ";2'503.75;;9'818.27;
22.03.2022;22.03.2022;" Dompotalitatete / Fer.-An. 8473685561 PUENTABIT ALITTIS ET OMULTUMULCERATA 528 VI 2725 QUAESUS Minvente: SUM / 6322.88/AN.4621610364/XXX. 33.37/CUM.76.32.1772/Tenda Comusquarass /Postorimurem ";;8'171.82;12'322.02;
22.03.2022;22.03.2022;" Dompotalitatete / Fer.-An. 6127113823 PUENTABIT ALITTIS ET OMULTUMULCERATA 528 VI 2725 QUAESUS Minvente: SUM / 5564.87/AN.3185507443/XXX. 74.32/CUM.76.32.1772/Minabyssit Carget Os/Visu ";;1'288.97;4'150.20;
22.03.2022;22.03.2022;" Dompotalitatete / Fer.-An. 7163658751 Quadram X. + Color Quadram E. Lormivicat 34 8680 Restom VI Minvente: Parturbit xxx LetionsolvespiLluvit wiriputus: 22560654 ";;50.00;2'861.23;
21.03.2022;21.03.2022;" Dompotalitatete / Fer.-An. 4412604117 CALET Decelione ET Curusquitoditagnum 35 8678 Restom VI Minvente: 566888 CALET ph43y2x2-11ev-1845-m17 6-68sp7857v536 Conimo 28158720 Frent: 67.80 Pote: -8.30 ";;64.06;2'811.23;
21.03.2022;21.03.2022;" Duxertibi x-mulegar / Fer.-An. 2236708413 MARATUS SCHIUVA ET MATERUNIUSTANERITA 41Y VI-2725 QUAESUS Ipascultum: CALTUBIT 32485303 ";1'526.70;;2'747.17;
21.03.2022;21.03.2022;" Duxertibi x-mulegar / Fer.-An. 5538864372 NOCUREANGUNIT E/D FUGE POST QUE 6-8 DE-5253 ALIBI Ipascultum: PRIANGERAGO. 484404 Achium: DEO 280.58 Miundimicum: 6.635603 (DEO/CAT) ";543.85;;4'273.87;
21.03.2022;21.03.2022;" Duxertibi x-mulegar / Fer.-An. 7633437523 REQUAE MITUUNT LODIVIT CANTURRURRE: 72521536 Ipascultum: 470824081051 ";1'000.00;;4'817.72;
21.03.2022;21.03.2022;" Dompotalitatete / Fer.-An. 6531151571 Parte Nungun xxx/rier Parte-Moludo Brell Abigerbicente 8 2111 Paticent Minvente: Seculiuratum Insicia 7/7. 73851083. ";;2'074.90;5'817.72;
18.03.2022;18.03.2022;" Dompotalitatete / Fer.-An. 7433811271 ALEBIRCUM MOREQUAER FICURRUNGERUNDUX 665 VI-7033-RESTOM Minvente: NOCASTA 16052038 - ALONE AN. 36177 ";;1'500.00;3'742.82;
18.03.2022;18.03.2022;" Dompotalitatete / Fer.-An. 1766530756 CALET Decelione ET Curusquitoditagnum 35 8678 Restom VI Minvente: 566888 CALET ph43y2x2-11ev-1845-m17 6-68sp7857v536 Conimo 87810088 Frent: 236.87 Pote: -6.28 ";;102.65;2'242.82;
18.03.2022;18.03.2022;" Dompotalitatete / Fer.-An. 6007005377 HORAEST SupA-Flus rea Ricogit Orsectuundulli 86K 6025 Poegraer VI Minvente: Agrangerre 36.32.1772 ";;55.85;2'140.17;
18.03.2022;18.03.2022;" Dompotalitatete / Fer.-An. 7041608766 PUENTABIT ALITTIS ET OMULTUMULCERATA 528 VI 2725 QUAESUS Minvente: SUM / 821.87/AN.6878875003/XXX. 8.37/CUM.36.32.1772/Minabyssit Carget Os/Visu ";;323.02;2'084.32;
18.03.2022;18.03.2022;" Duxertibi x-mulegar / Fer.-An. 3505137553 SUB HORIEM 5 VOS FESSUPA 55340 RATE Ipascultum: MVT610725 + FST413575 + YHK108775 Achium: DEO 6'314.44 Miundimicum: 6.111616 (DEO/CAT) ";1'677.49;;1'761.30;
18.03.2022;18.03.2022;" Dompotalitatete / Fer.-An. 2678547716 Vima Pormiunt SupA Loccinguncro 88 VI-5553 Quintio Minvente: Pronervem-An. 60238873 Rimunt-An. 75736 ";;1'810.00;3'438.79;
17.03.2022;17.03.2022;" Dompotalitatete / Fer.-An. 2538652788 CALET Decelione ET Curusquitoditagnum 35 8678 Restom VI Minvente: 566888 CALET ph43y2x2-11ev-1845-m17 6-68sp7857v536 Conimo 37176328 Frent: 624.31 Pote: -8.86 ";;425.25;1'628.79;
17.03.2022;17.03.2022;" Dompotalitatete / Fer.-An. 8285280523 PUENTABIT ALITTIS ET OMULTUMULCERATA 528 VI 2725 QUAESUS Minvente: SUM / 3803.87/AN.3404670502/XXX. 36.87/CUM.58.32.1772/Tenda Comusquarass /Postorimurem ";;1'083.95;1'203.54;
17.03.2022;17.03.2022;" Duxertibi x-mulegar / Fer.-An. 6074748504 OS RELETRIT PER CEPTESECTUS 65 2182 RAE HAREPTA Ipascultum: 78477 Achium: DEO 6'887.87 Miundimicum: 6.125246 (DEO/CAT) ";1'360.73;;119.59;
17.03.2022;17.03.2022;" Duxertibi x-mulegar / Fer.-An. 1148634255 MARATUS SCHIUVA ET MATERUNIUSTANERITA 41Y VI-2725 QUAESUS Ipascultum: CALTUBIT 68165074 ";3'544.14;;1'480.32;
17.03.2022;17.03.2022;" Dompotalitatete / Fer.-An. 7700817745 Mista Flar Capinvel 484 6551 Ventas l.h. Muribi VI Minvente: Nocasta. 55058703 Orsuplam Ijcglnsy85 o 573 statest 850 o 573 Mista Flar ";;60.00;5'024.46;
16.03.2022;16.03.2022;" Dompotalitatete / Fer.-An. 3405858573 SALIGUSA ACTUS AT/SI COMNIX AUSCECT MUTUSQUAM ACTUS RESERERIECTUS 10 VI 5536 CONERIT CUTALE O Minvente: DOCULURY 51478688, MONUNTUM. 71222 ";;945.00;4'964.46;
16.03.2022;16.03.2022;" Dompotalitatete / Fer.-An. 4303048184 SALIGUSA ACTUS AT/SI COMNIX AUSCECT MUTUSQUAM ACTUS RESERERIECTUS 10 VI 5536 CONERIT CUTALE O Minvente: DOCULURY 51478688, MONUNTUM. 71222 ";;945.00;4'019.46;
16.03.2022;15.03.2022;Espoturres xxx Cuproxitalevarae SI Suctus Micto Olum Entendo Velis Sidescerrunt 75834215 58.32.1772 52:47;73.00;;3'074.46;
16.03.2022;16.03.2022;" Dompotalitatete / Fer.-An. 5320687140 Locecere-Inas Vernern Protespicura 48T 8565 Spopro OS VI ";;129.00;3'147.46;
16.03.2022;16.03.2022;" Duxertibi x-mulegar / Fer.-An. 2110465140 COMERET E/D MANTI FŒNUNGA QUE 5 7674 POTABILLI DIDUXEMOR Ipascultum: PENTE ME. 65171 74532 Achium: DEO 5'543.46 Miundimicum: 6.437013 (DEO/CAT) ";4'793.03;;3'018.46;
16.03.2022;16.03.2022;" Duxertibi x-mulegar / Fer.-An. 4746034575 PARDUXORBICARY BY MORDUCCIPE Ipascultum: 843114605 Achium: DEO 804.87 Miundimicum: 6.437013 (DEO/CAT) ";156.29;;7'811.49;
16.03.2022;16.03.2022;" Duxertibi x-mulegar / Fer.-An. 2265840421 I. PERINI PETIA E/D O PATIME 36 O XXX 2111 SUPERIS Ipascultum: WIROPRIUVICA Achium: DEO 7'285.87 Miundimicum: 6.437013 (DEO/CAT) ";2'622.27;;7'967.78;
16.03.2022;16.03.2022;" Duxertibi x-mulegar / Fer.-An. 5338252454 PUPA ANES SUPA 4774 AGRUS Ipascultum: 38376 ";140.10;;10'590.05;
16.03.2022;16.03.2022;" Duxertibi x-mulegar / Fer.-An. 7788315665 NUMEN COLENTUDIVENTIS ET CAPH POSSIDEANERIERE 15 7041 PERRUNGUS DE NUMEN Ipascultum: 2008145 ";59.40;;10'730.15;
16.03.2022;16.03.2022;" Duxertibi x-mulegar / Fer.-An. 6663686121 FERES TOGINGOBSTA XXX RAMENI ET SIVIARTATUBITA 75 VI-2075 ANSTATINUM Ipascultum: CALTUBIT 243704 INCRENTIORE ";37.75;;10'789.55;
16.03.2022;16.03.2022;" Duxertibi x-mulegar / Fer.-An. 7708435157 ACIT ANSIVIMEN E/D XXX 66326610 EMPUGE 448 DE-5253 ALIBI Ipascultum: 3147163 6430528 ";147.44;;10'827.30;
16.03.2022;16.03.2022;" Duxertibi x-mulegar / Fer.-An. 3484655107 LTDRT03.HAT ET TALITIORGENTIORTE 44 4613 HENTI Ipascultum: 71448 ";123.05;;10'974.74;
16.03.2022;16.03.2022;" Duxertibi x-mulegar / Fer.-An. 7360226813 MARATUS SCHIUVA ET MATERUNIUSTANERITA 41Y VI-2725 QUAESUS Ipascultum: CALTUBIT 28001385 ";784.00;;11'097.79;
15.03.2022;15.03.2022;" Dompotalitatete / Fer.-An. 4683445683 CALET Decelione ET Curusquitoditagnum 35 8678 Restom VI Minvente: 566888 CALET ph43y2x2-11ev-1845-m17 6-68sp7857v536 Conimo 27428425 Frent: 3548.87 Pote: -65.27 ";;1'097.55;11'881.79;
15.03.2022;15.03.2022;" Duxertibi x-mulegar / Fer.-An. 7180826744 HORIGE ETUBIT NUNTEQUE MERETIRUNT 81 3535 SCET Ipascultum: CONDABITA ";963.00;;10'784.24;
15.03.2022;15.03.2022;" Dompotalitatete / Fer.-An. 1682422445 CALET Decelione ET Curusquitoditagnum 35 8678 Restom VI Minvente: 566888 CALET ph43y2x2-11ev-1845-m17 6-68sp7857v536 Conimo 81363820 Frent: 1658.87 Pote: -36.55 ";;1'261.39;11'747.24;
15.03.2022;15.03.2022;" Dompotalitatete / Fer.-An. 1722756431 Avadedram. Test Notubi-Curacit 51 6562 Bentircum(Prigris) VI Minvente: sectulum-an: 14444302 Milorüflavidem Eiundabstale: Avadedram Test ";;2'079.00;10'485.85;
15.03.2022;15.03.2022;" Duxertibi x-mulegar / Fer.-An. 2751713101 SERABO ICUTINTUM CONTI FUNDUCELIS 10U 6026 RACINAM-PRAT Ipascultum: 17558548 Achium: DEO 6'271.87 Miundimicum: 6.217045 (DEO/CAT) ";3'905.62;;8'406.85;
15.03.2022;13.03.2022;Espoturres xxx Cuproxitalevarae Vitræ Tücone Visu Entendo Velis Sidescerrunt 75834215 52.32.1772 65:52;103.70;;12'312.47;
15.03.2022;15.03.2022;" Dompotalitatete / Fer.-An. 6816107173 PUENTABIT ALITTIS ET OMULTUMULCERATA 528 VI 2725 QUAESUS Minvente: SUM / 7562.88/AN.5385666480/XXX. 677.67/CUM.71.32.1772/Tenda Comusquarass /Postorimurem ";;7'964.96;12'416.17;
15.03.2022;15.03.2022;" Dompotalitatete / Fer.-An. 4508666543 PUENTABIT ALITTIS ET OMULTUMULCERATA 528 VI 2725 QUAESUS Minvente: SUM / 544.87/AN.8680107432/XXX. 20.67/CUM.71.32.1772/Minabyssit Carget Os/Visu ";;913.17;4'451.21;
14.03.2022;14.03.2022;" Asputulieresex / Fer.-An. 1103621402 Virantrum: MERUNTO TUUNTAVARIDEINATU Avingemüin: CAT 5.44 ";;3'208.00;3'538.04;
14.03.2022;14.03.2022;" Duxertibi x-mulegar / Fer.-An. 6108772752 OMPECENERAE ET ANTIANAVIDECTIONE 3 8687 PEDDUS ET ";1'746.90;;330.04;
14.03.2022;14.03.2022;" Duxertibi x-mulegar / Fer.-An. 8153555866 FORE XXX PIRAERUNT 20 6452 VISU Ipascultum: PARE ";4'229.90;;2'076.94;
14.03.2022;14.03.2022;" Duxertibi x-mulegar / Fer.-An. 5141008730 COLECEPS POSTENS COMUSQUARASS STATTIMEMOTUM 42 12704 VENTUNT RONIANAVIDE Ipascultum: 771503 Achium: DEO 6'838.14 Miundimicum: 6.861838 (DEO/CAT) ";1'163.41;;6'306.84;
14.03.2022;14.03.2022;" Duxertibi x-mulegar / Fer.-An. 3385134028 INGUNIFINCH SUPA PAGNIBURENDO 73 7072 TIMORPUTAS Ipascultum: EA62/118161 Achium: DEO 5'141.58 Miundimicum: 6.861838 (DEO/CAT) ";4'324.61;;7'470.25;
14.03.2022;14.03.2022;" Duxertibi x-mulegar / Fer.-An. 7776817185 INTIS RAMENI SUPA SIVISQUIUVA 14 15451 ELLIQUAER Ipascultum: 6342657 7863515 Achium: DEO 6'230.46 Miundimicum: 6.861838 (DEO/CAT) ";1'582.81;;11'794.86;
14.03.2022;14.03.2022;" Dompotalitatete / Fer.-An. 2647406387 PUENTABIT ALITTIS ET OMULTUMULCERATA 528 VI 2725 QUAESUS Minvente: SUM / 783.87/AN.8382781148/XXX. 24.77/CUM.24.32.1772/Minabyssit Carget Os/Visu ";;511.98;13'377.67;
14.03.2022;14.03.2022;" Dompotalitatete / Fer.-An. 1018707813 Minabyssit Carget SupA Piraerunt 20 6452 Visu VI ";;10'000.00;12'865.69;
14.03.2022;12.03.2022;Espoturres xxx Cuproxitalevarae Intrisurriava-1663 O Entendo Velis Sidescerrunt 75834215 71.32.1772 24:73;179.85;;2'865.69;
14.03.2022;12.03.2022;Espoturres xxx Cuproxitalevarae Disu-4555 Poegraer Entendo Velis Sidescerrunt 75834215 71.32.1772 24:76;63.20;;3'045.54;
11.03.2022;11.03.2022;" Dompotalitatete / Fer.-An. 8582142212 CALET Decelione ET Curusquitoditagnum 35 8678 Restom VI Minvente: 566888 CALET ph43y2x2-11ev-1845-m17 6-68sp7857v536 Conimo 45807822 Frent: 547.87 Pote: -8.28 ";;412.57;3'108.74;
11.03.2022;11.03.2022;" Dompotalitatete / Fer.-An. 3224833007 SONDABEM Noteropirex ET Carectus. 510 2656 Ver b.Quaesus VI ";;909.00;2'696.17;
11.03.2022;11.03.2022;" Dompotalitatete / Fer.-An. 5255744185 NUNGUN MOTENTE K/N PROW LAE DIATHO PERANGRAESTAE 52 VI 7752 QUAESUS Minvente: NOCASTA 57587701 ";;64.00;1'787.17;
11.03.2022;11.03.2022;" Duxertibi x-mulegar / Fer.-An. 1458130430 ACIT ANSIVIMEN E/D XXX 66326610 EMPUGE 448 DE-5253 ALIBI Ipascultum: 4241623 4801142 ";974.57;;1'723.17;
11.03.2022;11.03.2022;" Duxertibi x-mulegar / Fer.-An. 4662386404 XY8 OCCANARANSI IMPAGITTRUNIMUS 86 VI 3531 SOLO ";269.25;;2'697.74;
11.03.2022;11.03.2022;" Dompotalitatete / Fer.-An. 8827361075 PUENTABIT ALITTIS ET OMULTUMULCERATA 528 VI 2725 QUAESUS Minvente: SUM / 7645.80/AN.4471020077/XXX. 75.64/CUM.84.32.1772/Minabyssit Carget Os/Visu ";;1'485.64;2'966.99;
10.03.2022;10.03.2022;" Duxertibi x-mulegar / Fer.-An. 2688602444 FLUMENT DICA ET INTENTEQUITA 42 2312 POSTORIMUREM Ipascultum: LITUM ";4'125.00;;1'481.35;
10.03.2022;10.03.2022;" Dompotalitatete / Fer.-An. 2782402864 Minabyssit Carget SupA Piraerunt 20 6452 Visu VI ";;2'000.00;5'606.35;
10.03.2022;10.03.2022;" Dompotalitatete / Fer.-An. 6807267883 CALET Decelione ET Curusquitoditagnum 35 8678 Restom VI Minvente: 566888 CALET ph43y2x2-11ev-1845-m17 6-68sp7857v536 Conimo 35674737 Frent: 546.87 Pote: -7.33 ";;191.48;3'606.35;
10.03.2022;10.03.2022;" Dompotalitatete / Fer.-An. 3348372222 PUENTABIT ALITTIS ET OMULTUMULCERATA 528 VI 2725 QUAESUS Minvente: SUM / 232.86/AN.6803266154/XXX. 65.25/CUM.53.32.1772/Minabyssit Carget Os/Visu ";;747.98;3'414.87;
09.03.2022;09.03.2022;" Duxertibi x-mulegar / Fer.-An. 2778176131 DEPRIT CARGET NATEMENS SUPA TUITQUONSIEM 65 4184 COMINATE Ipascultum: CALTUBIT 6210533457 ";1'992.30;;2'666.89;
09.03.2022;09.03.2022;" Duxertibi x-mulegar / Fer.-An. 5101132600 ADERE OVITA CLAVILIS Ipascultum: SUUNDIVITA (CANAVA PUTURRATRA) ";93.00;;4'659.19;
09.03.2022;09.03.2022;" Duxertibi x-mulegar / Fer.-An. 2238401464 REQUAE MITUUNT LODIVIT CANTURRURRE: 72521536 Ipascultum: 470824081051 ";2'500.00;;4'752.19;
09.03.2022;09.03.2022;" Dompotalitatete / Fer.-An. 5737264444 PUENTABIT ALITTIS ET OMULTUMULCERATA 528 VI 2725 QUAESUS Minvente: SUM / 708.87/AN.8625506852/XXX. 65.70/CUM.88.32.1772/Minabyssit Carget Os/Visu ";;752.33;7'252.19;
09.03.2022;09.03.2022;" Duxertibi x-mulegar / Fer.-An. 3541124637 I. PERINI PETIA E/D O PATIME 36 O XXX 2111 SUPERIS Ipascultum: WIROPRIUVICA Achium: DEO 7'285.87 Miundimicum: 6.432708 (DEO/CAT) ";2'576.81;;6'499.86;
08.03.2022;08.03.2022;" Dompotalitatete / Fer.-An. 6332074560 CALET Decelione ET Curusquitoditagnum 35 8678 Restom VI Minvente: 566888 CALET ph43y2x2-11ev-1845-m17 6-68sp7857v536 Conimo 21508026 Frent: 3303.87 Pote: -24.58 ";;3'807.85;9'076.67;
08.03.2022;08.03.2022;" Dompotalitatete / Fer.-An. 7430221061 CALET Decelione ET Curusquitoditagnum 35 8678 Restom VI Minvente: 566888 CALET ph43y2x2-11ev-1845-m17 6-68sp7857v536 Conimo 82643573 Frent: 866.87 Pote: -6.24 ";;265.50;5'268.82;
08.03.2022;08.03.2022;" Dompotalitatete / Fer.-An. 5066270775 Alane Atiam Labilluctungita 4 3405 Facipilliquare VI Minvente: Agincendum. 57606252, 2aSghvdhs Vaterrelitum dus Acteray,2aSghvdhs Todione,2aSghvdhs prieris,2aSghvdhs Notuligures ";;966.00;5'003.32;
08.03.2022;08.03.2022;" Duxertibi x-mulegar / Fer.-An. 6784708531 TUIT. BIBULIATUBSICULO PAUT PRINANDULIBENS IDESTALENTERTE 5143 SOLO ";4'023.60;;4'037.32;
08.03.2022;08.03.2022;" Duxertibi x-mulegar / Fer.-An. 5044873583 ALBULO TUDICTEQUAER ET 2641 AGRUS ";1'299.20;;8'060.92;
08.03.2022;08.03.2022;" Duxertibi x-mulegar / Fer.-An. 3320854835 PLETUR PERVA OS 1524 SAESTA ";2'000.00;;9'360.12;
08.03.2022;08.03.2022;" Dompotalitatete / Fer.-An. 5257708246 PUENTABIT ALITTIS ET OMULTUMULCERATA 528 VI 2725 QUAESUS Minvente: SUM / 6703.87/AN.1707821463/XXX. 42.87/CUM.87.32.1772/Tenda Comusquarass /Postorimurem ";;4'321.06;11'360.12;
08.03.2022;08.03.2022;" Dompotalitatete / Fer.-An. 1563083276 PUENTABIT ALITTIS ET OMULTUMULCERATA 528 VI 2725 QUAESUS Minvente: SUM / 645.87/AN.8830061057/XXX. 65.47/CUM.47.32.1772/Minabyssit Carget Os/Visu ";;716.96;7'039.06;
07.03.2022;07.03.2022;" Dompotalitatete / Fer.-An. 3325565502 Queriam Adecidis Os. Imulo-Curacit 70 8388 Deanava Minvente: Exemplebillibi 40006365 ";;200.00;6'322.10;
07.03.2022;07.03.2022;" Duxertibi x-mulegar / Fer.-An. 4263006512 PERIT PRIS ET CAPH INTUDIMICERNETUUNNO 2 6412 DIRENUIERNES Milorüflavidem Eiundabstale: TENDA COMUSQUARASS MINABYSSIT CARGET SUPA ";378.40;;6'122.10;
07.03.2022;07.03.2022;" Duxertibi x-mulegar / Fer.-An. 8554014003 FERES ET TOGINGOBSTA + RAMENI ET SIVIARTATUBITA 75 2075 ANSTATINUM ";680.40;;6'500.50;
07.03.2022;07.03.2022;" Dompotalitatete / Fer.-An. 7582341663 PUENTABIT ALITTIS ET OMULTUMULCERATA 528 VI 2725 QUAESUS Minvente: SUM / 5533.88/AN.1211840100/XXX. 55.67/CUM.32.32.1772/Tenda Comusquarass /Postorimurem ";;4'620.97;7'180.90;
04.03.2022;04.03.2022;" Dompotalitatete / Fer.-An. 7018528821 CALET Decelione ET Curusquitoditagnum 35 8678 Restom VI Minvente: 566888 CALET ph43y2x2-11ev-1845-m17 6-68sp7857v536 Conimo 51543850 Frent: 518.87 Pote: -8.17 ";;433.29;2'559.93;
04.03.2022;04.03.2022;" Duxertibi x-mulegar / Fer.-An. 7345288030 ETHENI QUADDUPA SUPA PERTEMPOSTIONGA 81 3038 SENSIME Ipascultum: PRONERVEM-AN.: 3020537712 ";36.85;;2'126.64;
04.03.2022;04.03.2022;" Duxertibi x-mulegar / Fer.-An. 2381425632 PONCH PECTERO 2312 POSTORIMUREM Ipascultum: EINUMN FIGNA MAGINTA ";100.00;;2'163.49;
04.03.2022;04.03.2022;" Duxertibi x-mulegar / Fer.-An. 6204653480 SPOST TUS IPLUM 3872 INCULINQUO Ipascultum: PARE ";4'035.90;;2'263.49;
04.03.2022;04.03.2022;" Duxertibi x-mulegar / Fer.-An. 1601855865 ACIA HOC FEST BY AUTE-PRATUDIGILLUUNT 4 3058 QUIURGENS BONIBUS Ipascultum: SPOTART 7125531 - ET 16126484 Achium: DEO 372.10 Miundimicum: 6.157551 (DEO/CAT) ";1'001.11;;6'299.39;
04.03.2022;04.03.2022;" Duxertibi x-mulegar / Fer.-An. 5183171225 WIRERRE-MODIX SALIA SUPA + EX. OS NUNT-SALIA-DUCEAT 5 23116 PRODICILE RONIANAVIDE Ipascultum: 16772835 Achium: DEO 87.33 Miundimicum: 6.157551 (DEO/CAT) ";98.20;;7'300.50;
04.03.2022;04.03.2022;" Dompotalitatete / Fer.-An. 3657042108 PUENTABIT ALITTIS ET OMULTUMULCERATA 528 VI 2725 QUAESUS Minvente: SUM / 271.75/AN.6536255110/XXX. 52.35/CUM.77.32.1772/Minabyssit Carget Os/Visu ";;726.29;7'398.70;
03.03.2022;03.03.2022;" Dompotalitatete / Fer.-An. 8107848423 CALET Decelione ET Curusquitoditagnum 35 8678 Restom VI Minvente: 566888 CALET ph43y2x2-11ev-1845-m17 6-68sp7857v536 Conimo 17540615 Frent: 5617.87 Pote: -27.82 ";;3'475.23;6'672.41;
03.03.2022;03.03.2022;" Dompotalitatete / Fer.-An. 7516583754 MELL DITUERNA K/N PROW MUTUSQUAM DITUERNA PARGENUMETURRE 76 VI 2866 CONERE N. PARATATERE Minvente: 37176328 ";;725.00;3'197.18;
03.03.2022;03.03.2022;" Dompotalitatete / Fer.-An. 2054484808 LANTI FACIA ANTATINO K/N PROW SYLLION FLUM CAPH LAVIDETANGA 44 O VI 7674 PARATATERE Minvente: DOCULURY-AN.: 55660378 ";;2'278.00;2'472.18;
03.03.2022;03.03.2022;" Dompotalitatete / Fer.-An. 6441857183 PUENTABIT ALITTIS ET OMULTUMULCERATA 528 VI 2725 QUAESUS Minvente: SUM / 87.87/AN.4434721161/XXX. 6.67/CUM.11.32.1772/Minabyssit Carget Os/Visu ";;92.17;194.18;
03.03.2022;03.03.2022;" Duxertibi x-mulegar / Fer.-An. 6726516087 SUARESTAS PLUMN GRIEIUSQUIDE 5 3061 IUSIMETINI Ipascultum: 87832006 ";403.90;;102.01;
03.03.2022;03.03.2022;" Duxertibi x-mulegar / Fer.-An. 8830374852 ETE OCULAR 8021 HENTI ";1'000.00;;505.91;
02.03.2022;02.03.2022;" Dompotalitatete / Fer.-An. 5461704461 CALET Decelione ET Curusquitoditagnum 35 8678 Restom VI Minvente: 566888 CALET ph43y2x2-11ev-1845-m17 6-68sp7857v536 Conimo 48307404 Frent: 628.87 Pote: -7.87 ";;152.00;1'505.91;
02.03.2022;02.03.2022;" Duxertibi x-mulegar / Fer.-An. 7878376887 CORE XXX OCUS-AGO ET RAEPELERIURIATE 20 4667 CALL Ipascultum: CALTUBIT: 414 285 XXX: 11.77.1772 Milorüflavidem Eiundabstale: MINABYSSIT CARGET SUPA ";289.70;;1'353.91;
02.03.2022;02.03.2022;" Duxertibi x-mulegar / Fer.-An. 1081721555 EQUIETRAY ET HIUM PORGERSUSTA 86 1228 TODESTABET-VALI Ipascultum: CALTUBIT AN. 56118514 ";25.00;;1'643.61;
02.03.2022;02.03.2022;" Duxertibi x-mulegar / Fer.-An. 2525585086 PANTHO PRATU BANIUNC 78M 4555 MULUDIVINTE Ipascultum: PARE ";1'727.54;;1'668.61;
02.03.2022;02.03.2022;" Duxertibi x-mulegar / Fer.-An. 1507158404 ACIT ANSIVIMEN E/D XXX 66326610 EMPUGE 448 DE-5253 ALIBI Ipascultum: 4536458 1572241 ";599.46;;3'396.15;
02.03.2022;02.03.2022;" Dompotalitatete / Fer.-An. 5368167146 Minabyssit Carget SupA Piraerunt 20 6452 Visu VI Minvente: Langunti ";;3'000.00;3'995.61;
02.03.2022;02.03.2022;" Duxertibi x-mulegar / Fer.-An. 8810515882 ADIEM XXX MINVEST TUMULIS E.D LEBRUNUM MINTRÆ STA. ME. 24 24067 PRIEIUM IMETE TUUNCRO Ipascultum: INSICIA GRAESPITUDO SALL 73.7.81 Achium: DEO 347.20 Miundimicum: 6.723730 (DEO/CAT) ";329.17;;995.61;
02.03.2022;02.03.2022;" Duxertibi x-mulegar / Fer.-An. 7634026323 I. PERINI PETIA E/D O PATIME 36 O XXX 2111 SUPERIS Ipascultum: WIROPRIUVICA Achium: DEO 7'285.87 Miundimicum: 6.723730 (DEO/CAT) ";2'599.44;;1'324.78;
02.03.2022;02.03.2022;" Dompotalitatete / Fer.-An. 5045855857 Simunam Divirunt Parideruccum 55 7674 Paratatere Minvente: Sectulum-An.: 13201427 cale Simunam Divirunt Parideruccum 55 ";;141.00;3'924.22;
02.03.2022;02.03.2022;" Dompotalitatete / Fer.-An. 8532275000 Tartia Gundie Diatem Supem Wirestam 52 6126 Scundabase Minvente: Exemplebillibi 12671037 ";;1'477.00;3'783.22;
01.03.2022;01.03.2022;" Duxertibi x-mulegar / Fer.-An. 8103606088 NUMEN COLENTUDIVENTIS ET CAPH POSSIDEANERIERE 15 7041 PERRUNGUS DE NUMEN Ipascultum: 6631682 ";364.55;;2'306.22;
01.03.2022;01.03.2022;" Duxertibi x-mulegar / Fer.-An. 2768674546 CONEIS SOLVERTIO OS ETE OPRANENSONE, 7 7711 DEIUSTA Ipascultum: CALIDES 3755 ";82.65;;2'670.77;
01.03.2022;01.03.2022;" Dompotalitatete / Fer.-An. 8850471332 CALET Decelione ET Curusquitoditagnum 35 8678 Restom VI Minvente: 566888 CALET ph43y2x2-11ev-1845-m17 6-68sp7857v536 Conimo 86130185 Frent: 536.87 Pote: -7.74 ";;170.75;2'753.42;
01.03.2022;01.03.2022;" Dompotalitatete / Fer.-An. 7202523321 CALET Decelione ET Curusquitoditagnum 35 8678 Restom VI Minvente: 566888 CALET ph43y2x2-11ev-1845-m17 6-68sp7857v536 Conimo 63133652 Frent: 368.87 Pote: -6.55 ";;249.71;2'582.67;
01.03.2022;01.03.2022;" Dompotalitatete / Fer.-An. 7448578202 RELENIS INITI K/N PROW ARTINE INITI OSTATINO 4 VI 7703 TRASSINFIG Minvente: PARTURBIT CUNT 3NO8 INITI ";;89.00;2'332.96;
01.03.2022;01.03.2022;" Dompotalitatete / Fer.-An. 6132777175 PUENTABIT ALITTIS ET OMULTUMULCERATA 528 VI 2725 QUAESUS Minvente: SUM / 546.88/AN.4470383601/XXX. 5.22/CUM.64.77.1772/Minabyssit Carget Os/Visu ";;220.47;2'243.96;
01.03.2022;01.03.2022;" Duxertibi x-mulegar / Fer.-An. 5422051404 INTIS RAMENI SUPA SIVISQUIUVA 14 15451 ELLIQUAER Ipascultum: 812136 251040 Achium: DEO 6'448.80 Miundimicum: 6.767332 (DEO/CAT) ";1'073.69;;2'023.49;
01.03.2022;01.03.2022;" Duxertibi x-mulegar / Fer.-An. 3002088235 SUCET PARTE SUPA TRATUMENTUDIEM-PLUS-ORE.7 21316 ADIXILATIBEM Ipascultum: CALTUBIT Achium: DEO 6'256.87 Miundimicum: 6.767332 (DEO/CAT) ";1'830.29;;3'097.18;
01.03.2022;01.03.2022;" Duxertibi x-mulegar / Fer.-An. 7668751870 PATESTERE RIPILLIGENIFIG COLO SIT 1021 SOLO ";634.00;;4'927.46;
01.03.2022;01.03.2022;" Duxertibi x-mulegar / Fer.-An. 8848128834 PATESTERE RIPILLIGENIFIG COLO SIT 1021 SOLO ";150.00;;5'561.46;
01.03.2022;01.03.2022;" Duxertibi x-mulegar / Fer.-An. 6385467241 PERIT PRIS ET AESENTERVADES 6412 DIRENUIERNES ";718.55;;5'711.46;
01.03.2022;01.03.2022;" Duxertibi x-mulegar / Fer.-An. 3161374322 PERIT PRIS ET CAPH INTUDIMICERNETUUNNO 2 6412 DIRENUIERNES Milorüflavidem Eiundabstale: TENDA COMUSQUARASS MINABYSSIT CARGET SUPA ";32.15;;6'430.01;
01.03.2022;01.03.2022;" Duxertibi x-mulegar / Fer.-An. 2265441813 PATEM (QUAESUS) DECESTEMPLABER SED ADENIUM 1848 QUAESUS ";227.20;;6'462.16;
01.03.2022;28.02.2022;Espoturres xxx Cuproxitalevarae Aureriam Mirepe Entendo Velis Sidescerrunt 75834215 34.77.1772 20:73;60.00;;6'689.36;
28.02.2022;28.02.2022;" Dompotalitatete / Fer.-An. 5544152272 Lanti Relle Inumedeperea 34 5583 Flac ";;1'577.00;6'749.36;
28.02.2022;28.02.2022;" Duxertibi x-mulegar / Fer.-An. 5580402127 ACIT ANSIVIMEN E/D XXX 66326610 EMPUGE 448 DE-5253 ALIBI Ipascultum: 4513646 ";350.17;;5'172.36;
28.02.2022;28.02.2022;" Dompotalitatete / Fer.-An. 4834221662 CALET Decelione ET Curusquitoditagnum 35 8678 Restom VI Minvente: 566888 CALET ph43y2x2-11ev-1845-m17 6-68sp7857v536 Conimo 12121026 Frent: 581.87 Pote: -73.71 ";;843.88;5'522.53;
28.02.2022;28.02.2022;" Duxertibi x-mulegar / Fer.-An. 7828063872 PLUM REQUER OS VOS IN CENTABO 4 VI-7702 FRAEST 5 ";138.50;;4'678.65;
28.02.2022;28.02.2022;" Duxertibi x-mulegar / Fer.-An. 8481647110 PERIT PRIS ET CAPH INTUDIMICERNETUUNNO 2 6412 DIRENUIERNES Milorüflavidem Eiundabstale: TENDA COMUSQUARASS MINABYSSIT CARGET SUPA ";204.50;;4'817.15;
28.02.2022;28.02.2022;" Duxertibi x-mulegar / Fer.-An. 1730820631 ACIT ANSIVIMEN E/D XXX 66326610 EMPUGE 448 DE-5253 ALIBI Ipascultum: 4745416 ";1'265.15;;5'021.65;
28.02.2022;28.02.2022;" Dompotalitatete / Fer.-An. 4551584700 PUENTABIT ALITTIS ET OMULTUMULCERATA 528 VI 2725 QUAESUS Minvente: SUM / 1046.80/AN.7601853746/XXX. 16.44/CUM.22.77.1772/Minabyssit Carget Os/Visu ";;1'116.15;6'286.80;
28.02.2022;28.02.2022;" Duxertibi x-mulegar / Fer.-An. 4816155618 VIMILLIUNUISUS SOLOGINGUNTIT- DEBICITE CALE GRO FLUNDIVISCURIRUNT 6438 QUAESUS ";610.00;;5'170.65;
28.02.2022;28.02.2022;" Duxertibi x-mulegar / Fer.-An. 2802758430 HORIGE ETUBIT NUNTEQUE MERETIRUNT 81 3535 SCET Ipascultum: PARE ";3'519.25;;5'780.65;
28.02.2022;28.02.2022;" Duxertibi x-mulegar / Fer.-An. 1177303120 QUILLE XXX PIRAERUNT 20 6452 VISU Ipascultum: PARE ";2'240.45;;9'299.90;
28.02.2022;28.02.2022;" Duxertibi x-mulegar / Fer.-An. 5026055880 VEGUN COR DERETE BASPUTAGRATONDAS 15 8050 DOLLIGUNGULLITI Ipascultum: PARE ";1'132.15;;11'540.35;
28.02.2022;28.02.2022;" Dompotalitatete / Fer.-An. 2571520315 Solonunde Ventur Expedectio 6 6438 Quaesus VI Minvente: Comerricus ";;314.00;12'672.50;
28.02.2022;28.02.2022;" Dompotalitatete / Fer.-An. 7103780553 Aespia Tus Conformissivis 108 6844 Numquadrae VI ";;37.90;12'358.50;
28.02.2022;28.02.2022;" Dompotalitatete / Fer.-An. 6178080531 Songula Domprow xxx Postrit Crevolenterfices 8 6844 Horminquam ET VI Minvente: Nocasta An. 63086507Doqthi An. 216 57Aicwxp Periero ";;389.00;12'320.60;
25.02.2022;25.02.2022;" Dompotalitatete / Fer.-An. 7214655241 Expere Aquaerundum Perunt 28 2308 Vispieinter Minvente: Exemplebillibi: 51767563 ";;1'900.00;11'931.60;
25.02.2022;25.02.2022;" Dompotalitatete / Fer.-An. 1236458772 Criusta Inas Geris Ausustinvem 6T 6731 Mircirede EX VI Minvente: Doculury An: 25107130 ";;1'966.00;10'031.60;
25.02.2022;25.02.2022;" Dompotalitatete / Fer.-An. 6046088087 CALET Decelione ET Curusquitoditagnum 35 8678 Restom VI Minvente: 566888 CALET ph43y2x2-11ev-1845-m17 6-68sp7857v536 Conimo 65443471 Frent: 657.87 Pote: -7.88 ";;212.20;8'065.60;
25.02.2022;25.02.2022;" Duxertibi x-mulegar / Fer.-An. 3400000848 DISSUAEST COMILEVEM LOCTUUM Ipascultum: YFF02-1688287 Achium: DEO 426.37 Miundimicum: 6.432080 (DEO/CAT) ";994.64;;7'853.40;
25.02.2022;25.02.2022;" Duxertibi x-mulegar / Fer.-An. 1360000407 ACIT ANSIVIMEN E/D XXX 66326610 EMPUGE 448 DE-5253 ALIBI Ipascultum: 4145557 1603315 1842308 5474617 3467874 3011843 ";1'125.13;;8'848.04;
25.02.2022;25.02.2022;" Duxertibi x-mulegar / Fer.-An. 7140024054 PESTAM BASSUM ET PARTUBIT 8270 7104 DESEVETE ";421.90;;9'973.17;
25.02.2022;25.02.2022;" Dompotalitatete / Fer.-An. 8821587131 Status Suuntum. Tiant Mirect Cuntumniunc 5 6125 Cange VI ";;90.00;10'395.07;
24.02.2022;24.02.2022;" Dompotalitatete / Fer.-An. 1401536284 CALET Decelione ET Curusquitoditagnum 35 8678 Restom VI Minvente: 566888 CALET ph43y2x2-11ev-1845-m17 6-68sp7857v536 Conimo 24837860 Frent: 104.87 Pote: -5.46 ";;521.14;10'305.07;
24.02.2022;24.02.2022;" Duxertibi x-mulegar / Fer.-An. 2215406100 PERIT PRIS ET CAPH INTUDIMICERNETUUNNO 2 6412 DIRENUIERNES Milorüflavidem Eiundabstale: TENDA COMUSQUARASS MINABYSSIT CARGET SUPA ";157.10;;9'783.93;
24.02.2022;24.02.2022;" Duxertibi x-mulegar / Fer.-An. 5728864303 PERIT PRIS ET CAPH INTUDIMICERNETUUNNO 2 6412 DIRENUIERNES Milorüflavidem Eiundabstale: TENDA COMUSQUARASS MINABYSSIT CARGET SUPA ";35.45;;9'941.03;
24.02.2022;24.02.2022;" Duxertibi x-mulegar / Fer.-An. 3121181286 PERIT PRIS ET CAPH INTUDIMICERNETUUNNO 2 6412 DIRENUIERNES Milorüflavidem Eiundabstale: TENDA COMUSQUARASS MINABYSSIT CARGET SUPA ";102.10;;9'976.48;
24.02.2022;24.02.2022;" Duxertibi x-mulegar / Fer.-An. 6034786650 PERIT PRIS ET CAPH INTUDIMICERNETUUNNO 2 6412 DIRENUIERNES Milorüflavidem Eiundabstale: TENDA COMUSQUARASS MINABYSSIT CARGET SUPA ";138.60;;10'078.58;
24.02.2022;24.02.2022;" Duxertibi x-mulegar / Fer.-An. 6576272573 ALBULO TUDICTEQUAER ET 2641 AGRUS ";1'947.00;;10'217.18;
24.02.2022;24.02.2022;" Duxertibi x-mulegar / Fer.-An. 8514037230 SENDIUSA MENTURAESCHODO 6623 OS. FICITA ";460.20;;12'164.18;
24.02.2022;24.02.2022;" Duxertibi x-mulegar / Fer.-An. 7036206240 SALCHRIS ALITTIS ET QUISCUTANGUN 82 2762 QUAESUS ";83.85;;12'624.38;
24.02.2022;24.02.2022;" Duxertibi x-mulegar / Fer.-An. 3538104284 SALCHRIS ALITTIS ET QUISCUTANGUN 82 2762 QUAESUS ";117.00;;12'708.23;
24.02.2022;24.02.2022;" Duxertibi x-mulegar / Fer.-An. 4017241710 SALCHRIS ALITTIS ET QUISCUTANGUN 82 2762 QUAESUS ";167.60;;12'825.23;
24.02.2022;24.02.2022;" Duxertibi x-mulegar / Fer.-An. 2206242734 SALCHRIS ALITTIS ET QUISCUTANGUN 82 2762 QUAESUS ";178.95;;12'992.83;
24.02.2022;24.02.2022;" Duxertibi x-mulegar / Fer.-An. 7857640030 ALBULO TUDICTEQUAER ET 2641 AGRUS ";1'275.90;;13'171.78;
24.02.2022;24.02.2022;" Duxertibi x-mulegar / Fer.-An. 5216513355 PERIT PRIS ET CAPH INTUDIMICERNETUUNNO 2 6412 DIRENUIERNES Milorüflavidem Eiundabstale: TENDA COMUSQUARASS MINABYSSIT CARGET SUPA ";383.05;;14'447.68;
24.02.2022;24.02.2022;" Duxertibi x-mulegar / Fer.-An. 4807513817 MITUNIS SUPA PUNTE SUBI 6 4118 VADUCERAM Ipascultum: 357673 123336 761432 621873 ";809.90;;14'830.73;
24.02.2022;24.02.2022;" Duxertibi x-mulegar / Fer.-An. 5486357066 PERIT PRIS ET AESENTERVADES 6412 DIRENUIERNES ";539.45;;15'640.63;
24.02.2022;24.02.2022;" Duxertibi x-mulegar / Fer.-An. 7078453783 PERIT PRIS ET AESENTERVADES 6412 DIRENUIERNES ";435.95;;16'180.08;
24.02.2022;24.02.2022;" Duxertibi x-mulegar / Fer.-An. 6251253314 PERIT PRIS ET CAPH INTUDIMICERNETUUNNO 2 6412 DIRENUIERNES Milorüflavidem Eiundabstale: TENDA COMUSQUARASS MINABYSSIT CARGET SUPA ";123.60;;16'616.03;
24.02.2022;24.02.2022;" Duxertibi x-mulegar / Fer.-An. 4737103471 PERIT PRIS ET CAPH INTUDIMICERNETUUNNO 2 6412 DIRENUIERNES Milorüflavidem Eiundabstale: TENDA COMUSQUARASS MINABYSSIT CARGET SUPA ";100.20;;16'739.63;
24.02.2022;24.02.2022;" Duxertibi x-mulegar / Fer.-An. 6370873544 PERIT PRIS ET CAPH INTUDIMICERNETUUNNO 2 6412 DIRENUIERNES Milorüflavidem Eiundabstale: TENDA COMUSQUARASS MINABYSSIT CARGET SUPA ";259.70;;16'839.83;
24.02.2022;24.02.2022;" Duxertibi x-mulegar / Fer.-An. 4345020303 PERIT PRIS ET CAPH INTUDIMICERNETUUNNO 2 6412 DIRENUIERNES Milorüflavidem Eiundabstale: TENDA COMUSQUARASS MINABYSSIT CARGET SUPA ";163.60;;17'099.53;
24.02.2022;24.02.2022;" Duxertibi x-mulegar / Fer.-An. 5376116644 PERIT PRIS ET CAPH INTUDIMICERNETUUNNO 2 6412 DIRENUIERNES Milorüflavidem Eiundabstale: TENDA COMUSQUARASS MINABYSSIT CARGET SUPA ";204.30;;17'263.13;
24.02.2022;24.02.2022;" Duxertibi x-mulegar / Fer.-An. 2764718522 PERIT PRIS ET CAPH INTUDIMICERNETUUNNO 2 6412 DIRENUIERNES Milorüflavidem Eiundabstale: TENDA COMUSQUARASS MINABYSSIT CARGET SUPA ";161.35;;17'467.43;
24.02.2022;24.02.2022;" Duxertibi x-mulegar / Fer.-An. 3853826184 TRIUM EXIMULIGUSA ET MUSQUAESPILIQUISU 5 6532 VENTESPULIQUE ";322.80;;17'628.78;
24.02.2022;24.02.2022;" Duxertibi x-mulegar / Fer.-An. 3751546723 TRIUM EXIMULIGUSA ET MUSQUAESPILIQUISU 5 6532 VENTESPULIQUE ";322.80;;17'951.58;
24.02.2022;24.02.2022;" Duxertibi x-mulegar / Fer.-An. 5343387765 TRIUM EXIMULIGUSA ET MUSQUAESPILIQUISU 5 6532 VENTESPULIQUE ";322.80;;18'274.38;
24.02.2022;24.02.2022;" Duxertibi x-mulegar / Fer.-An. 2813074110 TRIUM EXIMULIGUSA ET MUSQUAESPILIQUISU 5 6532 VENTESPULIQUE ";322.80;;18'597.18;
23.02.2022;23.02.2022;" Duxertibi x-mulegar / Fer.-An. 4451805351 AQUADA + DERUM ET CENTEGRAESCHAT 3 6562 PUTURBIREM ";240.10;;18'919.98;
23.02.2022;23.02.2022;" Duxertibi x-mulegar / Fer.-An. 2280688428 AQUADA + DERUM ET CENTEGRAESCHAT 3 6562 PUTURBIREM ";413.00;;19'160.08;
23.02.2022;23.02.2022;" Duxertibi x-mulegar / Fer.-An. 4670553842 AQUADA + DERUM ET CENTEGRAESCHAT 3 6562 PUTURBIREM ";89.00;;19'573.08;
23.02.2022;23.02.2022;" Duxertibi x-mulegar / Fer.-An. 4343205143 AQUADA + DERUM ET CENTEGRAESCHAT 3 6562 PUTURBIREM ";283.65;;19'662.08;
23.02.2022;23.02.2022;" Duxertibi x-mulegar / Fer.-An. 1838553076 AQUADA + DERUM ET CENTEGRAESCHAT 3 6562 PUTURBIREM ";370.60;;19'945.73;
23.02.2022;23.02.2022;" Duxertibi x-mulegar / Fer.-An. 5275155585 REQUISQUAEPRORODERE SAT MILIGNA OCULAR 8021 HENTI SUBIENT ";300.00;;20'316.33;
23.02.2022;23.02.2022;" Duxertibi x-mulegar / Fer.-An. 3225340340 ETE OCULAR 8021 HENTI ";3'044.00;;20'616.33;
23.02.2022;23.02.2022;" Duxertibi x-mulegar / Fer.-An. 4273427376 SALCHRIS ALITTIS ET QUISCUTANGUN 82 2762 QUAESUS ";157.95;;23'660.33;
23.02.2022;23.02.2022;" Duxertibi x-mulegar / Fer.-An. 8676850764 SALCHRIS ALITTIS ET QUISCUTANGUN 82 2762 QUAESUS ";122.65;;23'818.28;
23.02.2022;23.02.2022;" Duxertibi x-mulegar / Fer.-An. 7066808750 NABIERE SPLATURELES OS PROTER VI W'STUS 42Q 2615 INNERIA-LOR-PASCRETE ";6.00;;23'940.93;
23.02.2022;23.02.2022;" Dompotalitatete / Fer.-An. 4445476865 CALET Decelione ET Curusquitoditagnum 35 8678 Restom VI Minvente: 566888 CALET ph43y2x2-11ev-1845-m17 6-68sp7857v536 Conimo 26541513 Frent: 7648.87 Pote: -10.47 ";;2'735.96;23'946.93;
23.02.2022;23.02.2022;" Dompotalitatete / Fer.-An. 4246634731 PUENTABIT ALITTIS ET OMULTUMULCERATA 528 VI 2725 QUAESUS Minvente: SUM / 8778.87/AN.8623358611/XXX. 22.34/CUM.16.77.1772/Minabyssit Carget Os/Visu ";;1'267.28;21'210.97;
23.02.2022;23.02.2022;" Duxertibi x-mulegar / Fer.-An. 5035448801 COLECEPS POSTENS COMUSQUARASS STATTIMEMOTUM 42 12704 VENTUNT RONIANAVIDE Ipascultum: 548671 Achium: DEO 75.87 Miundimicum: 6.863157 (DEO/CAT) ";74.33;;19'943.69;
23.02.2022;23.02.2022;" Duxertibi x-mulegar / Fer.-An. 5477206253 I. PERINI PETIA E/D O PATIME 36 O XXX 2111 SUPERIS Ipascultum: WIROPRIUVICA Achium: DEO 7'285.87 Miundimicum: 6.863157 (DEO/CAT) ";2'654.47;;20'018.02;
23.02.2022;23.02.2022;" Duxertibi x-mulegar / Fer.-An. 2340526840 XXX SAEQUENTO OS PLIQUIDEANTENT 55 4184 COMINATE Ipascultum: INCRENTIORE ";4.75;;22'672.49;
23.02.2022;23.02.2022;" Duxertibi x-mulegar / Fer.-An. 2285577246 CRECIPSE ALITTIS ET LUNIMERVELINTIS 642 8762 MATERE Ipascultum: 38870533 ";211.09;;22'677.24;
23.02.2022;23.02.2022;" Duxertibi x-mulegar / Fer.-An. 1024742531 IMORIA FORBICULA ET GRANATTERE 247 5213 INO ";156.15;;22'888.33;
23.02.2022;23.02.2022;" Duxertibi x-mulegar / Fer.-An. 5442844320 RECT VI ET NUNTHEDIDENTE PLEBITTITUDIT 4704 SOLO ";39.85;;23'044.48;
23.02.2022;23.02.2022;" Duxertibi x-mulegar / Fer.-An. 7754664062 NIS INICO RECT ET 5572 MOLUS ET ";273.80;;23'084.33;
23.02.2022;23.02.2022;" Duxertibi x-mulegar / Fer.-An. 6654373275 INUMN ENTINIES ET LONIUNTATRUNDABULA 71 6568 CRIERTUUNT Ipascultum: 2220643 ";386.35;;23'358.13;
23.02.2022;23.02.2022;" Duxertibi x-mulegar / Fer.-An. 7320501011 PARAT DUONGUN DUCTAVICAT D.E.T.W 4202 HUNDUS ";61.00;;23'744.48;
23.02.2022;23.02.2022;" Duxertibi x-mulegar / Fer.-An. 2610386036 HOC ALITTIS ET ADDUCUNTURRANAVA 35 4567 MOLUS EX ";93.20;;23'805.48;
23.02.2022;23.02.2022;" Duxertibi x-mulegar / Fer.-An. 7604422067 HOC ALITTIS ET ADDUCUNTURRANAVA 35 4567 MOLUS EX ";133.30;;23'898.68;
23.02.2022;23.02.2022;" Duxertibi x-mulegar / Fer.-An. 3516050606 INCUNTO ADDUERADO ET PAURREHETTETUS 4 4074 SIVENGULLA Milorüflavidem Eiundabstale: MINABYSSIT CARGET SUPA ";169.80;;24'031.98;
23.02.2022;23.02.2022;" Duxertibi x-mulegar / Fer.-An. 3508626167 XXX SAEQUENTO OS ETE OPRANENSONE 22 7711 DEIUSTA ";399.10;;24'201.78;
23.02.2022;23.02.2022;" Duxertibi x-mulegar / Fer.-An. 8707812318 CORE XXX OCUS-AGO ET RAEPELERIURIATE 20 4667 CALL Ipascultum: CALTUBIT: 414 751 XXX: 20.11.81 Milorüflavidem Eiundabstale: MINABYSSIT CARGET SUPA ";177.35;;24'600.88;
23.02.2022;23.02.2022;" Duxertibi x-mulegar / Fer.-An. 3803886730 PESTAM BASSUM ET PARTUBIT 8270 7104 DESEVETE ";44.60;;24'778.23;
23.02.2022;23.02.2022;" Duxertibi x-mulegar / Fer.-An. 6334470178 PESTAM BASSUM ET PARTUBIT 8270 7104 DESEVETE ";28.75;;24'822.83;
23.02.2022;23.02.2022;" Duxertibi x-mulegar / Fer.-An. 5677041347 ACIDEANNO ET 6562 OBANDISTA ";809.35;;24'851.58;
23.02.2022;23.02.2022;" Duxertibi x-mulegar / Fer.-An. 4050220405 ACIDEANNO ET 6562 OBANDISTA ";29.05;;25'660.93;
22.02.2022;22.02.2022;" Dompotalitatete / Fer.-An. 5037224883 CALET Decelione ET Curusquitoditagnum 35 8678 Restom VI Minvente: 566888 CALET ph43y2x2-11ev-1845-m17 6-68sp7857v536 Conimo 58525035 Frent: 753.87 Pote: -6.13 ";;250.70;25'689.98;
22.02.2022;22.02.2022;" Dompotalitatete / Fer.-An. 3171013320 CALET Decelione ET Curusquitoditagnum 35 8678 Restom VI Minvente: 566888 CALET ph43y2x2-11ev-1845-m17 6-68sp7857v536 Conimo 52213560 Frent: 387.87 Pote: -5.53 ";;309.92;25'439.28;
22.02.2022;22.02.2022;" Dompotalitatete / Fer.-An. 7207888355 CALET Decelione ET Curusquitoditagnum 35 8678 Restom VI Minvente: 566888 CALET ph43y2x2-11ev-1845-m17 6-68sp7857v536 Conimo 84856336 Frent: 148.87 Pote: -8.11 ";;683.99;25'129.36;
22.02.2022;21.02.2022;Espoturres xxx Cuproxitalevarae Funteé Conditate OS Entendo Velis Sidescerrunt 75834215 16.77.1772 58:53;195.50;;24'445.37;
22.02.2022;22.02.2022;" Dompotalitatete / Fer.-An. 6234766735 PUENTABIT ALITTIS ET OMULTUMULCERATA 528 VI 2725 QUAESUS Minvente: SUM / 764.87/AN.3742532566/XXX. 65.75/CUM.77.77.1772/Minabyssit Carget Os/Visu ";;733.73;24'640.87;
22.02.2022;22.02.2022;" Dompotalitatete / Fer.-An. 7758848815 PUENTABIT ALITTIS ET OMULTUMULCERATA 528 VI 2725 QUAESUS Minvente: SUM / 6736.80/AN.6673673012/XXX. 76.67/CUM.42.77.1772/Tenda Comusquarass /Postorimurem ";;3'716.07;23'907.14;
22.02.2022;22.02.2022;" Dompotalitatete / Fer.-An. 8751648736 PUENTABIT ALITTIS ET OMULTUMULCERATA 528 VI 2725 QUAESUS Minvente: SUM / 547.87/AN.1515554338/XXX. 8.20/CUM.42.77.1772/Minabyssit Carget Os/Visu ";;410.42;20'191.07;
22.02.2022;22.02.2022;" Dompotalitatete / Fer.-An. 1807243364 PUENTABIT ALITTIS ET OMULTUMULCERATA 528 VI 2725 QUAESUS Minvente: SUM / 6855.87/AN.2822748168/XXX. 46.55/CUM.76.77.1772/Minabyssit Carget Os/Visu ";;2'863.19;19'780.65;
21.02.2022;21.02.2022;" Dompotalitatete / Fer.-An. 8611504127 CALET Decelione ET Curusquitoditagnum 35 8678 Restom VI Minvente: 566888 CALET ph43y2x2-11ev-1845-m17 6-68sp7857v536 Conimo 47672122 Frent: 262.87 Pote: -6.14 ";;277.35;16'917.46;
21.02.2022;21.02.2022;" Dompotalitatete / Fer.-An. 6548035423 MIRE NATE GATE NAVENS CURACIT 44 VI 6562 BENTIRCUM (PRIGRIS) Minvente: EXEMPLEBILLIBI: 17002107 ";;7'700.00;16'640.11;
21.02.2022;21.02.2022;" Dompotalitatete / Fer.-An. 2886812236 Vinae Tentaturo Curgerum Cardungulluus 71 6125 Cange VI Minvente: Nocasta: 22051127 ";;1'897.50;8'940.11;
21.02.2022;21.02.2022;" Dompotalitatete / Fer.-An. 4814820161 PUENTABIT ALITTIS ET OMULTUMULCERATA 528 VI 2725 QUAESUS Minvente: SUM / 8446.87/AN.8025181677/XXX. 8.55/CUM.20.77.1772/Tenda Comusquarass /Postorimurem ";;1'044.39;7'042.61;
21.02.2022;21.02.2022;" Dompotalitatete / Fer.-An. 8286347251 PUENTABIT ALITTIS ET OMULTUMULCERATA 528 VI 2725 QUAESUS Minvente: SUM / 380.87/AN.6466057372/XXX. 76.88/CUM.20.77.1772/Minabyssit Carget Os/Visu ";;929.93;5'998.22;
21.02.2022;21.02.2022;" Duxertibi x-mulegar / Fer.-An. 6824482540 REQUAE MITUUNT LODIVIT CANTURRURRE: 72521536 Ipascultum: 470824081051 ";2'500.00;;5'068.29;
21.02.2022;21.02.2022;" Dompotalitatete / Fer.-An. 7108657543 Nover Salectum Salvensicano 51 VI-4403 Icidifinto Minvente: Caperahede. 24833582 Rimunt.An: 80237 306.87 modifig de 75.71.4487 sta. pus Tenda-Comusquarass ";;945.00;7'568.29;
18.02.2022;18.02.2022;" Duxertibi x-mulegar / Fer.-An. 7705711486 NATINANT INIAVIDUSPECTUBIT 16 8388 DEANAVA Ipascultum: 772028 ";142.00;;6'623.29;
18.02.2022;18.02.2022;" Dompotalitatete / Fer.-An. 1467551614 CALET Decelione ET Curusquitoditagnum 35 8678 Restom VI Minvente: 566888 CALET ph43y2x2-11ev-1845-m17 6-68sp7857v536 Conimo 85527065 Frent: 178.80 Pote: -8.77 ";;546.70;6'765.29;
18.02.2022;18.02.2022;" Duxertibi x-mulegar / Fer.-An. 3275142103 MISTA SILLUMENT 1718 SAELONENT Ipascultum: SUUNDIVITA ";170.00;;6'218.59;
18.02.2022;18.02.2022;" Dompotalitatete / Fer.-An. 8164538541 HORAEST SupA-Flus rea Ricogit Orsectuundulli 86K 6025 Poegraer VI Minvente: Agrangerre 58.77.1772 ";;183.40;6'388.59;
18.02.2022;18.02.2022;" Duxertibi x-mulegar / Fer.-An. 5470428421 PUPA ANES SUPA 4774 AGRUS Ipascultum: 76818 ";541.40;;6'205.19;
18.02.2022;18.02.2022;" Duxertibi x-mulegar / Fer.-An. 7157280217 LTDRT03.HAT ET TALITIORGENTIORTE 44 4613 HENTI Ipascultum: LITUM SALLUUNTUUNT ";3'769.50;;6'746.59;
18.02.2022;18.02.2022;" Duxertibi x-mulegar / Fer.-An. 8368835610 ACIT ANSIVIMEN E/D XXX 66326610 EMPUGE 448 DE-5253 ALIBI Ipascultum: 2471373 1315681 5753753 2228757 4812462 ";2'457.02;;10'516.09;
18.02.2022;18.02.2022;" Duxertibi x-mulegar / Fer.-An. 8174744705 DEPRIT CARGET NATEMENS SUPA TUITQUONSIEM 65 4184 COMINATE Ipascultum: CALTUBIT 4264672144 ";4'660.00;;12'973.11;
18.02.2022;18.02.2022;" Duxertibi x-mulegar / Fer.-An. 8510222656 PUPA ANES SUPA 4774 AGRUS Ipascultum: 36408 ";813.25;;17'633.11;
18.02.2022;18.02.2022;" Dompotalitatete / Fer.-An. 8524516016 PUENTABIT ALITTIS ET OMULTUMULCERATA 528 VI 2725 QUAESUS Minvente: SUM / 1481.88/AN.6171300762/XXX. 8.24/CUM.36.77.1772/Tenda Comusquarass /Postorimurem ";;1'614.30;18'446.36;
18.02.2022;18.02.2022;" Dompotalitatete / Fer.-An. 8021672818 PUENTABIT ALITTIS ET OMULTUMULCERATA 528 VI 2725 QUAESUS Minvente: SUM / 603.87/AN.3731642838/XXX. 7.33/CUM.36.77.1772/Minabyssit Carget Os/Visu ";;152.01;16'832.06;
18.02.2022;18.02.2022;" Dompotalitatete / Fer.-An. 2751547248 Acciliunt RECT SupA Ungungus 76 6674 Faculi VI Minvente: Ascentro Duongun/GT8025348535/TM21087701/TD7/JH530.87/OS-77.10 ";;669.64;16'680.05;
18.02.2022;18.02.2022;" Dompotalitatete / Fer.-An. 5116045512 Cipulucum Lebra Orbis Prortudionficolli 7R VI-6257 Tratudicat Minvente: Doculury-An.: 83851654 ";;414.00;16'010.41;
18.02.2022;18.02.2022;" Duxertibi x-mulegar / Fer.-An. 8251205835 NOCUREANGUNIT E/D FUGE POST QUE 6-8 DE-5253 ALIBI Ipascultum: PRIANGERAGO. 886570 Achium: DEO 463.47 Miundimicum: 6.340210 (DEO/CAT) ";779.47;;15'596.41;
17.02.2022;17.02.2022;" Dompotalitatete / Fer.-An. 2567160637 CALET Decelione ET Curusquitoditagnum 35 8678 Restom VI Minvente: 566888 CALET ph43y2x2-11ev-1845-m17 6-68sp7857v536 Conimo 55481115 Frent: 510.87 Pote: -6.41 ";;132.26;16'375.88;
17.02.2022;17.02.2022;" Dompotalitatete / Fer.-An. 7218855540 MAXIMUM QUILA UNTIO PROTER IN HUNDO 27L VI 2158 VITUDO Minvente: PENTIURRUNTIS 73143) ";;200.00;16'243.62;
17.02.2022;17.02.2022;" Dompotalitatete / Fer.-An. 3468641524 Serbit N. xxx Serbit-Domni I. Quilocat 8 3187 Conerantimaxi VI Minvente: I-an.: 23312 E-an.: 71016832 ";;227.00;16'043.62;
17.02.2022;17.02.2022;" Duxertibi x-mulegar / Fer.-An. 3088585182 HOC ALITTIS ET ADDUCUNTURRANAVA 35 4567 MOLUS EX ";2'987.75;;15'816.62;
16.02.2022;16.02.2022;" Dompotalitatete / Fer.-An. 2224285645 PUENTABIT ALITTIS ET OMULTUMULCERATA 528 VI 2725 QUAESUS Minvente: SUM / 305.87/AN.5600581815/XXX. 5.81/CUM.65.77.1772/Minabyssit Carget Os/Visu ";;233.43;18'804.37;
16.02.2022;16.02.2022;" Duxertibi x-mulegar / Fer.-An. 1573643687 SUARESTAS PLUMN GRIEIUSQUIDE 5 3061 IUSIMETINI Ipascultum: 6281734330 7000008875 7721564565 6148675713 60004367 ";2'586.63;;18'570.94;
16.02.2022;16.02.2022;" Duxertibi x-mulegar / Fer.-An. 2112048424 I. PERINI PETIA E/D O PATIME 36 O XXX 2111 SUPERIS Ipascultum: WIROPRIUVICA Achium: DEO 7'285.87 Miundimicum: 6.716507 (DEO/CAT) ";2'673.18;;21'157.57;
16.02.2022;16.02.2022;" Dompotalitatete / Fer.-An. 4637845547 Iparipsimell Devegausa SupA Rederorbibus 28 3715 Henti Pope ";;114.00;23'830.75;
15.02.2022;15.02.2022;" Dompotalitatete / Fer.-An. 3506518685 CALET Decelione ET Curusquitoditagnum 35 8678 Restom VI Minvente: 566888 CALET ph43y2x2-11ev-1845-m17 6-68sp7857v536 Conimo 25176223 Frent: 686.87 Pote: -71.20 ";;923.83;23'716.75;
15.02.2022;15.02.2022;" Dompotalitatete / Fer.-An. 8125382452 CALET Decelione ET Curusquitoditagnum 35 8678 Restom VI Minvente: 566888 CALET ph43y2x2-11ev-1845-m17 6-68sp7857v536 Conimo 66674774 Frent: 575.87 Pote: -6.81 ";;112.52;22'792.92;
15.02.2022;15.02.2022;" Dompotalitatete / Fer.-An. 4143617337 PUENTABIT ALITTIS ET OMULTUMULCERATA 528 VI 2725 QUAESUS Minvente: SUM / 5067.87/AN.5185563548/XXX. 44.47/CUM.71.77.1772/Tenda Comusquarass /Postorimurem ";;3'354.49;22'680.40;
15.02.2022;15.02.2022;" Dompotalitatete / Fer.-An. 1541140266 PUENTABIT ALITTIS ET OMULTUMULCERATA 528 VI 2725 QUAESUS Minvente: SUM / 4371.80/AN.3754605220/XXX. 14.14/CUM.73.77.1772/Tenda Comusquarass /Postorimurem ";;8'343.58;19'325.91;
15.02.2022;15.02.2022;" Dompotalitatete / Fer.-An. 1341873838 Inquadde K. T. xxx Inquadde M. Pultificion 72l 3022 Tundam VI Minvente: 86646220 - Increntiore aursit Cocum more ";;1'814.00;10'982.33;
14.02.2022;14.02.2022;" Dompotalitatete / Fer.-An. 2703674251 Quila Postro Nequiderate 17 4813 Amplundi Minvente: Nocasta An. 66321807 Rimunt An 47350 propro Insicia parduonse Caranterem reles Toduceniantegi ";;1'289.00;9'168.33;
14.02.2022;14.02.2022;Obsemple-Possubilia 35556442 - DEM Visu Entendo Velis Sidescerrunt 75834215 65.77.1772 24:22;;4'140.00;7'879.33;
14.02.2022;14.02.2022;" Dompotalitatete / Fer.-An. 3675230755 CALET Decelione ET Curusquitoditagnum 35 8678 Restom VI Minvente: 566888 CALET ph43y2x2-11ev-1845-m17 6-68sp7857v536 Conimo 30551744 Frent: 487.87 Pote: -7.31 ";;216.15;3'739.33;
14.02.2022;14.02.2022;" Duxertibi x-mulegar / Fer.-An. 5602484422 VERBIBULI D.W. HABEAMUS CAURESTA I/ SCEM FERECT 5 OBANES 73 31008 PARISU LAMISU Ipascultum: CALTUBIT 5 / 7435 Achium: DEO 330.52 Miundimicum: 6.568281 (DEO/CAT) ";162.71;;3'523.18;
14.02.2022;14.02.2022;" Duxertibi x-mulegar / Fer.-An. 2362826613 INTIS RAMENI SUPA SIVISQUIUVA 14 15451 ELLIQUAER Ipascultum: 7564868 5658464 1761384 Achium: DEO 332.35 Miundimicum: 6.568281 (DEO/CAT) ";764.41;;3'685.89;
14.02.2022;14.02.2022;" Duxertibi x-mulegar / Fer.-An. 8241005360 ETHENI QUADDUPA SUPA PERTEMPOSTIONGA 81 3038 SENSIME Ipascultum: 7458407872 ";42.80;;4'450.30;
14.02.2022;14.02.2022;" Duxertibi x-mulegar / Fer.-An. 1301734180 SOLESTAM EXERA VOCCITUDISU 8G 4667 CALL Ipascultum: TINUIT NOCASTA 77832 ";124.00;;4'493.10;
14.02.2022;14.02.2022;" Dompotalitatete / Fer.-An. 8622257572 PUENTABIT ALITTIS ET OMULTUMULCERATA 528 VI 2725 QUAESUS Minvente: SUM / 3402.87/AN.5153777076/XXX. 13.51/CUM.24.77.1772/Tenda Comusquarass /Postorimurem ";;1'789.33;4'617.10;
14.02.2022;14.02.2022;" Dompotalitatete / Fer.-An. 2855823873 PUENTABIT ALITTIS ET OMULTUMULCERATA 528 VI 2725 QUAESUS Minvente: SUM / 8086.87/AN.6274543555/XXX. 81.33/CUM.24.77.1772/Minabyssit Carget Os/Visu ";;1'184.01;2'827.77;
14.02.2022;14.02.2022;" Dompotalitatete / Fer.-An. 2316816212 Lucuratius SupA Mundidecupro 28 6135 Dustent Minvente: Doculury Mombis 55747375 ";;113.10;1'643.76;
14.02.2022;11.02.2022;Espoturres xxx Cuproxitalevarae SI Suctus Micto Olum Entendo Velis Sidescerrunt 75834215 73.77.1772 42:53;32.00;;1'530.66;
11.02.2022;11.02.2022;" Dompotalitatete / Fer.-An. 8572610784 CALET Decelione ET Curusquitoditagnum 35 8678 Restom VI Minvente: 566888 CALET ph43y2x2-11ev-1845-m17 6-68sp7857v536 Conimo 71066806 Frent: 510.87 Pote: -5.81 ";;491.52;1'562.66;
11.02.2022;11.02.2022;" Duxertibi x-mulegar / Fer.-An. 6750671284 OMNA LEBRA N.U. MIUVIT 53-6 5338 VI XXX SEMPARTINCH Ipascultum: SPOTART 62104273 Achium: DEO 288.87 Miundimicum: 6.524176 (DEO/CAT) ";366.40;;1'071.14;
11.02.2022;11.02.2022;" Dompotalitatete / Fer.-An. 7125124000 PUENTABIT ALITTIS ET OMULTUMULCERATA 528 VI 2725 QUAESUS Minvente: SUM / 1083.87/AN.6482128836/XXX. 75.75/CUM.84.77.1772/Minabyssit Carget Os/Visu ";;1'423.30;1'437.54;
10.02.2022;10.02.2022;" Duxertibi x-mulegar / Fer.-An. 5681328781 REQUAE MITUUNT LODIVIT CANTURRURRE: 72521536 Ipascultum: 470824081051 ";2'500.00;;14.24;
09.02.2022;09.02.2022;" Duxertibi x-mulegar / Fer.-An. 7802737055 PUPA ANES SUPA 4774 AGRUS Ipascultum: 27417 ";781.35;;2'514.24;
09.02.2022;09.02.2022;" Duxertibi x-mulegar / Fer.-An. 8521783252 PUPA ANES SUPA 4774 AGRUS Ipascultum: 45575 ";557.00;;3'295.59;
09.02.2022;09.02.2022;" Dompotalitatete / Fer.-An. 6015710210 NAS QUILA STOROW VIVIONDISTAS 53 VI 1848 QUAESUS ";;728.00;3'852.59;
09.02.2022;09.02.2022;" Dompotalitatete / Fer.-An. 1208318176 Vellige Novio Pueriam Tensta Redrambulo 73 6143 Ditabo VI ";;32.00;3'124.59;
09.02.2022;09.02.2022;" Dompotalitatete / Fer.-An. 4611201654 PUENTABIT ALITTIS ET OMULTUMULCERATA 528 VI 2725 QUAESUS Minvente: SUM / 721.87/AN.1186465402/XXX. 6.34/CUM.88.77.1772/Minabyssit Carget Os/Visu ";;166.72;3'092.59;
09.02.2022;09.02.2022;" Dompotalitatete / Fer.-An. 5544521837 Mentem Caph Quartudivivita 2 5628 Vali Minvente: Nocasta 88045141 Tenda Comusquarass - Cunt ";;2'065.90;2'925.87;
08.02.2022;08.02.2022;" Dompotalitatete / Fer.-An. 4236221728 CALET Decelione ET Curusquitoditagnum 35 8678 Restom VI Minvente: 566888 CALET ph43y2x2-11ev-1845-m17 6-68sp7857v536 Conimo 50746673 Frent: 55.87 Pote: -8.55 ";;28.62;859.97;
08.02.2022;08.02.2022;" Dompotalitatete / Fer.-An. 8372006470 PUENTABIT ALITTIS ET OMULTUMULCERATA 528 VI 2725 QUAESUS Minvente: SUM / 14.87/AN.6720442780/XXX. 6.34/CUM.81.77.1772/Minabyssit Carget Os/Visu ";;63.72;831.35;
08.02.2022;08.02.2022;" Duxertibi x-mulegar / Fer.-An. 6742006163 RAPPOST NOVISUM D.I.E 13781 CARESSICUTUR PULIGUN Ipascultum: 4615427713 Achium: DEO 6'603.81 Miundimicum: 6.451008 (DEO/CAT) ";1'241.28;;767.63;
08.02.2022;08.02.2022;" Duxertibi x-mulegar / Fer.-An. 1660787342 I. PERINI PETIA E/D O PATIME 36 O XXX 2111 SUPERIS Ipascultum: WIROPRIUVICA Achium: DEO 7'285.87 Miundimicum: 6.451008 (DEO/CAT) ";2'686.25;;2'008.91;
08.02.2022;08.02.2022;" Dompotalitatete / Fer.-An. 2205358545 PUENTABIT ALITTIS ET OMULTUMULCERATA 528 VI 2725 QUAESUS Minvente: SUM / 387.87/AN.8757826322/XXX. 8.33/CUM.87.77.1772/Minabyssit Carget Os/Visu ";;308.01;4'695.16;
08.02.2022;08.02.2022;" Dompotalitatete / Fer.-An. 2176851036 PUENTABIT ALITTIS ET OMULTUMULCERATA 528 VI 2725 QUAESUS Minvente: SUM / 372.80/AN.2852722803/XXX. 8.75/CUM.47.77.1772/Tenda Comusquarass /Postorimurem ";;963.36;4'387.15;
08.02.2022;08.02.2022;" Dompotalitatete / Fer.-An. 6081567342 PUENTABIT ALITTIS ET OMULTUMULCERATA 528 VI 2725 QUAESUS Minvente: SUM / 141.87/AN.1406537848/XXX. 71.28/CUM.47.77.1772/Minabyssit Carget Os/Visu ";;635.57;3'423.79;
07.02.2022;07.02.2022;" Dompotalitatete / Fer.-An. 5623108700 Patine Unius Domuniuntalique 28 4245 Numquadrae VI Minvente: Dicolunice: 28606168 ";;35.00;2'788.22;
07.02.2022;07.02.2022;" Asputulieresex / Fer.-An. 8725474868 Virantrum: MERUNTO TUUNTAVARIDEINATU Avingemüin: CAT 6.24 ";;154.00;2'753.22;
07.02.2022;07.02.2022;" Duxertibi x-mulegar / Fer.-An. 8544851783 FLUMENT DICA ET INTENTEQUITA 42 2312 POSTORIMUREM Ipascultum: LITUM ";4'125.00;;2'599.22;
07.02.2022;07.02.2022;" Duxertibi x-mulegar / Fer.-An. 5713640241 XXX SAEQUENTO OS PLIQUIDEANTENT 55 4184 COMINATE Ipascultum: 6346134 ";373.00;;6'724.22;
07.02.2022;07.02.2022;" Duxertibi x-mulegar / Fer.-An. 3370413172 INCUNTO ADDUERADO ET SOLVENTQUAEROBAR 6 6568 CRIERTUUNT Ipascultum: 6833678471 ";503.15;;7'097.22;
07.02.2022;07.02.2022;" Dompotalitatete / Fer.-An. 1828161422 ADDUCI PERALIQUE ETE HOLO QUITA 58 VI 8283 REVOLENTO Minvente: 57153533 ";;1'369.00;7'600.37;
07.02.2022;07.02.2022;" Dompotalitatete / Fer.-An. 5422471267 CAPERCUSA PLUNTURA NOLVENTERACTO 2 VI 7226 OBASTAS Minvente: 75553880 CAPERCUSA PLUNTURA ";;2'089.00;6'231.37;
07.02.2022;07.02.2022;" Duxertibi x-mulegar / Fer.-An. 8163264734 OS RELETRIT PER CEPTESECTUS 65 2182 RAE HAREPTA Ipascultum: 64353 Achium: DEO 6'588.87 Miundimicum: 6.506305 (DEO/CAT) ";1'095.99;;4'142.37;
07.02.2022;07.02.2022;" Duxertibi x-mulegar / Fer.-An. 2234258306 INGUNIFINCH SUPA PAGNIBURENDO 73 7072 TIMORPUTAS Ipascultum: DK63/305207 Achium: DEO 8'724.80 Miundimicum: 6.506305 (DEO/CAT) ";5'424.87;;5'238.36;
07.02.2022;07.02.2022;" Dompotalitatete / Fer.-An. 3622111083 PUENTABIT ALITTIS ET OMULTUMULCERATA 528 VI 2725 QUAESUS Minvente: SUM / 618.24/AN.1273540662/XXX. 52.15/CUM.32.77.1772/Minabyssit Carget Os/Visu ";;688.66;10'663.23;
07.02.2022;07.02.2022;" Dompotalitatete / Fer.-An. 7277624112 PUENTABIT ALITTIS ET OMULTUMULCERATA 528 VI 2725 QUAESUS Minvente: SUM / 831.80/AN.1752638212/XXX. 8.15/CUM.32.77.1772/Tenda Comusquarass /Postorimurem ";;407.21;9'974.57;
04.02.2022;04.02.2022;" Dompotalitatete / Fer.-An. 3571361554 HORAEST SupA-Flus rea Ricogit Orsectuundulli 86K 6025 Poegraer VI Minvente: Agrangerre 34.11.1772 Capile Condione ";;87.10;9'567.36;
04.02.2022;04.02.2022;" Dompotalitatete / Fer.-An. 3076567322 PUENTABIT ALITTIS ET OMULTUMULCERATA 528 VI 2725 QUAESUS Minvente: SUM / 8153.88/AN.8485630654/XXX. 33.27/CUM.77.77.1772/Tenda Comusquarass /Postorimurem ";;5'330.35;9'480.26;
04.02.2022;04.02.2022;" Dompotalitatete / Fer.-An. 4156685608 PUENTABIT ALITTIS ET OMULTUMULCERATA 528 VI 2725 QUAESUS Minvente: SUM / 2728.87/AN.6607068870/XXX. 75.11/CUM.77.77.1772/Minabyssit Carget Os/Visu ";;1'416.99;4'149.91;
04.02.2022;03.02.2022;Espoturres xxx Cuproxitalevarae Aureriam Mirepe Entendo Velis Sidescerrunt 75834215 32.77.1772 65:73;94.00;;2'732.92;
04.02.2022;04.02.2022;" Duxertibi x-mulegar / Fer.-An. 4138847185 MARATUS SCHIUVA ET MATERUNIUSTANERITA 41Y VI-2725 QUAESUS Ipascultum: CALTUBIT 40730410 ";2'796.03;;2'826.92;
04.02.2022;04.02.2022;" Duxertibi x-mulegar / Fer.-An. 2338174758 QUATUR MATUS 7, PARSUPINT SAT SCENTABSTER 4202 HUNDUS Ipascultum: SUUNDIVITA ";20.00;;5'622.95;
04.02.2022;04.02.2022;" Duxertibi x-mulegar / Fer.-An. 5213335778 QUIUM POSSE FLABSENTIO.25 3266 COGINCERITA Ipascultum: TINUIT NOCASTA 71066806 ";94.00;;5'642.95;
04.02.2022;04.02.2022;" Duxertibi x-mulegar / Fer.-An. 5860465768 DEPRIT CARGET NATEMENS SUPA TUITQUONSIEM 65 4184 COMINATE Ipascultum: CALTUBIT 8347700771 ";73.20;;5'736.95;
04.02.2022;04.02.2022;" Duxertibi x-mulegar / Fer.-An. 5413322731 SALCHRIS ALITTIS ET PENDIGENDIT 73 8268 TIONE Ipascultum: 15185540 40252056 ";284.40;;5'810.15;
04.02.2022;04.02.2022;" Duxertibi x-mulegar / Fer.-An. 1160117167 ACIT ANSIVIMEN E/D XXX 66326610 EMPUGE 448 DE-5253 ALIBI Ipascultum: 5321175 4112135 4166222 6053273 5485023 6838884 ";226.98;;6'094.55;
04.02.2022;04.02.2022;" Duxertibi x-mulegar / Fer.-An. 7786880584 NUMEN COLENTUDIVENTIS ET CAPH POSSIDEANERIERE 15 7041 PERRUNGUS DE NUMEN Ipascultum: 5575562 ";113.75;;6'321.53;
04.02.2022;04.02.2022;" Duxertibi x-mulegar / Fer.-An. 7135241004 LTDRT03.HAT ET TALITIORGENTIORTE 44 4613 HENTI Ipascultum: LITUM NATUDO ";2'961.75;;6'435.28;
04.02.2022;04.02.2022;" Duxertibi x-mulegar / Fer.-An. 4557622438 LTDRT03.HAT ET 4613 HENTI Ipascultum: PRONERVEM-AN. - 11407 OFFICIONENITUS - 34.11.1772 ";328.50;;9'397.03;
04.02.2022;04.02.2022;" Duxertibi x-mulegar / Fer.-An. 5406742355 PANTHO PRATU BANIUNC 78M 4555 MULUDIVINTE Ipascultum: PARE ";1'809.43;;9'725.53;
04.02.2022;04.02.2022;" Duxertibi x-mulegar / Fer.-An. 7270708524 COMERET E/D MANTI FŒNUNGA QUE 5 7674 POTABILLI DIDUXEMOR Ipascultum: PENTE ME. 66588 Achium: DEO 8'436.44 Miundimicum: 6.572821 (DEO/CAT) ";5'570.33;;11'534.96;
04.02.2022;04.02.2022;" Duxertibi x-mulegar / Fer.-An. 5010133738 PARDUXORBICARY BY MORDUCCIPE Ipascultum: 303115132 Achium: DEO 804.87 Miundimicum: 6.572821 (DEO/CAT) ";159.63;;17'105.29;
04.02.2022;04.02.2022;" Duxertibi x-mulegar / Fer.-An. 7426131073 SERABO ICUTINTUM CONTI FUNDUCELIS 10U 6026 RACINAM-PRAT Ipascultum: 54140405 Achium: DEO 5'250.87 Miundimicum: 6.572821 (DEO/CAT) ";4'653.91;;17'264.92;
04.02.2022;04.02.2022;" Dompotalitatete / Fer.-An. 6185647811 Minabyssit Carget SupA Piraerunt 20 6452 Visu VI Minvente: Langunti ";;15'000.00;21'918.83;
03.02.2022;03.02.2022;" Dompotalitatete / Fer.-An. 4687658055 PUENTABIT ALITTIS ET OMULTUMULCERATA 528 VI 2725 QUAESUS Minvente: SUM / 232.87/AN.6647120134/XXX. 8.84/CUM.11.77.1772/Minabyssit Carget Os/Visu ";;382.44;6'918.83;
03.02.2022;03.02.2022;" Dompotalitatete / Fer.-An. 2271675423 Conch N. xxx Os Opterunc W. Videvatulunt 55 1173 Costa VI ";;154.00;6'536.39;
03.02.2022;03.02.2022;" Duxertibi x-mulegar / Fer.-An. 8847041645 TUIT. BIBULIATUBSICULO PAUT PRINANDULIBENS IDESTALENTERTE 5143 SOLO ";4'023.60;;6'382.39;
03.02.2022;03.02.2022;" Duxertibi x-mulegar / Fer.-An. 2684318205 ETE OCULAR 8021 HENTI ";1'000.00;;10'405.99;
03.02.2022;03.02.2022;" Duxertibi x-mulegar / Fer.-An. 6024854713 REQUAE MITUUNT LODIVIT CANTURRURRE: 72521536 Ipascultum: 470824081051 ";2'500.00;;11'405.99;
03.02.2022;03.02.2022;" Dompotalitatete / Fer.-An. 3517073328 Senducia Lucens rier Inequam Lorsiliquaticcana 24 8140 Turo EX VI ";;269.00;13'905.99;
02.02.2022;01.02.2022;Espoturres xxx Cuproxitalevarae Disu DE Plumemperare Entendo Velis Sidescerrunt 75834215 11.77.1772 71:88;48.95;;13'636.99;
02.02.2022;01.02.2022;Espoturres xxx Cuproxitalevarae Aureriam Mirepe Entendo Velis Sidescerrunt 75834215 11.77.1772 71:80;45.00;;13'685.94;
02.02.2022;02.02.2022;" Dompotalitatete / Fer.-An. 4415500652 PUENTABIT ALITTIS ET OMULTUMULCERATA 528 VI 2725 QUAESUS Minvente: SUM / 885.87/AN.2463458076/XXX. 5.26/CUM.44.11.1772/Minabyssit Carget Os/Visu ";;372.07;13'730.94;
02.02.2022;02.02.2022;" Duxertibi x-mulegar / Fer.-An. 1863078777 SUARESTAS PLUMN GRIEIUSQUIDE 5 3061 IUSIMETINI Ipascultum: 31606820 + 85753477 ";1'202.14;;13'358.87;
01.02.2022;01.02.2022;" Dompotalitatete / Fer.-An. 1124430385 CALET Decelione ET Curusquitoditagnum 35 8678 Restom VI Minvente: 566888 CALET ph43y2x2-11ev-1845-m17 6-68sp7857v536 Conimo 71016832 Frent: 332.87 Pote: -8.14 ";;707.68;14'561.01;
01.02.2022;01.02.2022;" Dompotalitatete / Fer.-An. 7454212226 CALET Decelione ET Curusquitoditagnum 35 8678 Restom VI Minvente: 566888 CALET ph43y2x2-11ev-1845-m17 6-68sp7857v536 Conimo 35274548 Frent: 606.80 Pote: -8.66 ";;452.94;13'853.33;
01.02.2022;01.02.2022;" Dompotalitatete / Fer.-An. 2526501743 CHOC INO PULI SUPIROTUM 4 VI 2230 FORETUDABERE Minvente: SUGATUDO MOLUS PENTE ";;41.00;13'400.39;
01.02.2022;01.02.2022;" Dompotalitatete / Fer.-An. 4416470380 PUENTABIT ALITTIS ET OMULTUMULCERATA 528 VI 2725 QUAESUS Minvente: SUM / 166.87/AN.6764758708/XXX. 71.20/CUM.13.11.1772/Minabyssit Carget Os/Visu ";;626.83;13'359.39;
01.02.2022;01.02.2022;" Dompotalitatete / Fer.-An. 4567737132 PUENTABIT ALITTIS ET OMULTUMULCERATA 528 VI 2725 QUAESUS Minvente: SUM / 1032.86/AN.8301134447/XXX. 31.22/CUM.55.11.1772/Tenda Comusquarass /Postorimurem ";;7'215.27;12'732.56;
01.02.2022;01.02.2022;" Dompotalitatete / Fer.-An. 6645350022 PUENTABIT ALITTIS ET OMULTUMULCERATA 528 VI 2725 QUAESUS Minvente: SUM / 7126.87/AN.2342112210/XXX. 33.10/CUM.55.11.1772/Minabyssit Carget Os/Visu ";;2'687.64;5'517.29;
01.02.2022;01.02.2022;" Dompotalitatete / Fer.-An. 6740666157 PUENTABIT ALITTIS ET OMULTUMULCERATA 528 VI 2725 QUAESUS Minvente: SUM / 784.80/AN.8815251731/XXX. 6.37/CUM.34.11.1772/Minabyssit Carget Os/Visu ";;202.92;2'829.65;
01.02.2022;01.02.2022;" Dompotalitatete / Fer.-An. 7548215203 Cocurem Putumelli Opinsent 81 4637 Ascautunc Minvente: 68655355 ";;2'005.00;2'626.73;
31.01.2022;31.01.2022;" Duxertibi x-mulegar / Fer.-An. 7118708616 INTIS RAMENI SUPA SIVISQUIUVA 14 15451 ELLIQUAER Ipascultum: 7428661 3822011 Achium: DEO 665.27 Miundimicum: 6.772247 (DEO/CAT) ";640.44;;621.73;
31.01.2022;31.01.2022;" Duxertibi x-mulegar / Fer.-An. 6437653636 I. PERINI PETIA E/D O PATIME 36 O XXX 2111 SUPERIS Ipascultum: WIROPRIUVICA Achium: DEO 7'285.87 Miundimicum: 6.772247 (DEO/CAT) ";2'640.12;;1'262.17;
31.01.2022;31.01.2022;" Duxertibi x-mulegar / Fer.-An. 2151445682 DEPRIT CARGET NATEMENS SUPA TUITQUONSIEM 65 4184 COMINATE Ipascultum: CALTUBIT 5505253712 ";1'740.00;;3'902.28;
31.01.2022;31.01.2022;" Duxertibi x-mulegar / Fer.-An. 5823457070 ACIT ANSIVIMEN E/D XXX 66326610 EMPUGE 448 DE-5253 ALIBI Ipascultum: 6658362 2056411 4745475 7400667 7438083 5875654 2538880 5886478 6080678 6011023 1846670 8701350 4188522 ";4'167.13;;5'642.28;
31.01.2022;31.01.2022;" Duxertibi x-mulegar / Fer.-An. 8335265446 VIMILLIUNUISUS SOLOGINGUNTIT- DEBICITE CALE GRO FLUNDIVISCURIRUNT 6438 QUAESUS ";1'773.20;;9'809.41;
31.01.2022;31.01.2022;" Duxertibi x-mulegar / Fer.-An. 1316612217 VIMILLIUNUISUS SOLOGINGUNTIT- DEBICITE CALE GRO FLUNDIVISCURIRUNT 6438 QUAESUS ";610.00;;11'582.61;
31.01.2022;31.01.2022;" Dompotalitatete / Fer.-An. 1267538668 SENTIUS GERCULA DOMNIUM AESENDUCTO 4 VI 8327 CERTAM Minvente: 78107402 ";;195.00;12'192.61;
31.01.2022;31.01.2022;" Dompotalitatete / Fer.-An. 5060255738 PUENTABIT ALITTIS ET OMULTUMULCERATA 528 VI 2725 QUAESUS Minvente: SUM / 628.87/AN.7807550422/XXX. 7.33/CUM.75.11.1772/Minabyssit Carget Os/Visu ";;151.01;11'997.61;
31.01.2022;31.01.2022;" Dompotalitatete / Fer.-An. 8045766686 Panius xxx Susterunt Docecto Paratiuntatire 65 2216 Ansonsi ET Minvente: Rimunt-An.44025 ";;1'582.00;11'846.60;
28.01.2022;28.01.2022;" Duxertibi x-mulegar / Fer.-An. 5525406714 HORIGE ETUBIT NUNTEQUE MERETIRUNT 81 3535 SCET Ipascultum: PARE ";3'519.25;;10'264.60;
28.01.2022;28.01.2022;" Duxertibi x-mulegar / Fer.-An. 6613618761 VEGUN COR DERETE BASPUTAGRATONDAS 15 8050 DOLLIGUNGULLITI Ipascultum: PARE ";1'132.15;;13'783.85;
28.01.2022;28.01.2022;" Duxertibi x-mulegar / Fer.-An. 2243014264 QUILLE XXX PIRAERUNT 20 6452 VISU Ipascultum: PARE ";3'519.25;;14'916.00;
28.01.2022;28.01.2022;" Dompotalitatete / Fer.-An. 2083510420 PUENTABIT ALITTIS ET OMULTUMULCERATA 528 VI 2725 QUAESUS Minvente: SUM / 354.87/AN.1301346501/XXX. 20.20/CUM.64.11.1772/Minabyssit Carget Os/Visu ";;876.83;18'435.25;
27.01.2022;27.01.2022;" Dompotalitatete / Fer.-An. 6410235581 Cripuer Tonum Domitagionentem 518 VI-3778 Traestabis Por Minvente: VEREQUO 88435357 ";;1'100.00;17'558.42;
27.01.2022;27.01.2022;" Duxertibi x-mulegar / Fer.-An. 8386638827 ADIEM TUMULIS E.D LEBRUNUM SI. LEBRUNUM MINTRÆ OS. 24 24067 PRIEIUM TUUNCRO Ipascultum: Y762484108152873 + INCRENTIORE Achium: DEO 7'230.88 Miundimicum: 6.505244 (DEO/CAT) ";2'667.93;;16'458.42;
27.01.2022;27.01.2022;" Duxertibi x-mulegar / Fer.-An. 1280552034 SUBSEMPLUVIA PERE D.T.W. ETE SCILITAGIT 52 82286 - SENSONIFILE OS TENTAM PULIGUN Ipascultum: DICTIS SI AN. 83201 Achium: DEO 6'466.77 Miundimicum: 6.505244 (DEO/CAT) ";3'469.53;;19'126.35;
27.01.2022;27.01.2022;" Duxertibi x-mulegar / Fer.-An. 8172860556 EVOLVESTEM DIEM 24 VOS VI CARERUM 24660 SERIS Ipascultum: 1772-46584 Achium: DEO 6'654.81 Miundimicum: 6.505244 (DEO/CAT) ";1'064.95;;22'595.88;
27.01.2022;27.01.2022;" Duxertibi x-mulegar / Fer.-An. 6811841210 PUPA ANES SUPA 4774 AGRUS Ipascultum: 25605 66650 16445 36713 ";1'062.30;;23'660.83;
27.01.2022;27.01.2022;" Duxertibi x-mulegar / Fer.-An. 6203765426 DEPRIT CARGET NATEMENS SUPA TUITQUONSIEM 65 4184 COMINATE Ipascultum: CALTUBIT 4550717410 ";1'910.45;;24'723.13;
27.01.2022;26.01.2022;Espoturres xxx Cuproxitalevarae Aureriam Mirepe Entendo Velis Sidescerrunt 75834215 64.11.1772 52:88;20.00;;26'633.58;
27.01.2022;26.01.2022;Espoturres xxx Cuproxitalevarae MINQUIENSI Entendo Velis Sidescerrunt 75834215 64.11.1772 52:73;39.80;;26'653.58;
27.01.2022;27.01.2022;" Dompotalitatete / Fer.-An. 3633200374 PUENTABIT ALITTIS ET OMULTUMULCERATA 528 VI 2725 QUAESUS Minvente: SUM / 507.87/AN.1368786654/XXX. 52.70/CUM.74.11.1772/Minabyssit Carget Os/Visu ";;699.33;26'693.38;
27.01.2022;27.01.2022;" Dompotalitatete / Fer.-An. 7263405221 Iunt Peria Orturrucili 87 6453 Dabiette VI Minvente: Doculury An. 16627608 ";;184.00;25'994.05;
26.01.2022;26.01.2022;" Dompotalitatete / Fer.-An. 7012823147 CALET Decelione ET Curusquitoditagnum 35 8678 Restom VI Minvente: 566888 CALET ph43y2x2-11ev-1845-m17 6-68sp7857v536 Conimo 14571476 Frent: 8153.87 Pote: -55.22 ";;2'226.67;25'810.05;
26.01.2022;26.01.2022;" Duxertibi x-mulegar / Fer.-An. 6252066456 CLAMBULO SUPA 4631 FLUMQUARDA DE SEGI Ipascultum: SUUNDIVITA + 8725307 + 6138754 ";18.15;;23'583.38;
26.01.2022;26.01.2022;" Duxertibi x-mulegar / Fer.-An. 3210372688 NUMEN COLENTUDIVENTIS ET CAPH POSSIDEANERIERE 15 7041 PERRUNGUS DE NUMEN Ipascultum: 6102226 ";828.50;;23'601.53;
26.01.2022;26.01.2022;" Duxertibi x-mulegar / Fer.-An. 1206578003 POTE-TEM SUPA INIETUM. 36 38747 CASCIT RONIANAVIDE Ipascultum: 1772-3128317 Achium: DEO 7'123.67 Miundimicum: 6.441380 (DEO/CAT) ";2'593.71;;24'430.03;
26.01.2022;26.01.2022;" Duxertibi x-mulegar / Fer.-An. 2375086680 SERABO ICUTINTUM CONTI FUNDUCELIS 10U 6026 RACINAM-PRAT Ipascultum: 58403868 Achium: DEO 275.35 Miundimicum: 6.441380 (DEO/CAT) ";152.47;;27'023.74;
26.01.2022;26.01.2022;" Dompotalitatete / Fer.-An. 3485430068 PUENTABIT ALITTIS ET OMULTUMULCERATA 528 VI 2725 QUAESUS Minvente: SUM / 5600.87/AN.6583328327/XXX. 46.73/CUM.22.11.1772/Minabyssit Carget Os/Visu ";;2'838.89;27'176.21;
25.01.2022;25.01.2022;" Duxertibi x-mulegar / Fer.-An. 4631807455 SCEPS INVENT UMENTIATENIUNIX 6S 3318 SOLO Ipascultum: PROLAMAGRANT ";254.00;;24'337.32;
25.01.2022;25.01.2022;" Dompotalitatete / Fer.-An. 6310777363 CALET Decelione ET Curusquitoditagnum 35 8678 Restom VI Minvente: 566888 CALET ph43y2x2-11ev-1845-m17 6-68sp7857v536 Conimo 28257711 Frent: 751.87 Pote: -5.33 ";;531.01;24'591.32;
25.01.2022;25.01.2022;" Dompotalitatete / Fer.-An. 2268004560 Ellunam Suunt Stattimemotum 5u 7041 Perrungus de Numen VI Minvente: Pronervem an. 60823535 ";;30.00;24'060.31;
25.01.2022;25.01.2022;" Duxertibi x-mulegar / Fer.-An. 1443288148 INTIS RAMENI SUPA SIVISQUIUVA 14 15451 ELLIQUAER Ipascultum: 2517274 7616886 5716063 1450336 Achium: DEO 6'775.88 Miundimicum: 6.471128 (DEO/CAT) ";1'616.70;;24'030.31;
25.01.2022;25.01.2022;" Dompotalitatete / Fer.-An. 8712513530 PUENTABIT ALITTIS ET OMULTUMULCERATA 528 VI 2725 QUAESUS Minvente: SUM / 510.87/AN.7246172700/XXX. 8.33/CUM.73.11.1772/Minabyssit Carget Os/Visu ";;488.48;25'647.01;
25.01.2022;25.01.2022;" Dompotalitatete / Fer.-An. 6447043143 PUENTABIT ALITTIS ET OMULTUMULCERATA 528 VI 2725 QUAESUS Minvente: SUM / 7365.87/AN.6520221863/XXX. 484.77/CUM.81.11.1772/Tenda Comusquarass /Postorimurem ";;7'939.98;25'158.53;
25.01.2022;25.01.2022;" Dompotalitatete / Fer.-An. 4638435523 PUENTABIT ALITTIS ET OMULTUMULCERATA 528 VI 2725 QUAESUS Minvente: SUM / 753.87/AN.2235137042/XXX. 5.23/CUM.81.11.1772/Minabyssit Carget Os/Visu ";;249.12;17'218.55;
25.01.2022;25.01.2022;" Dompotalitatete / Fer.-An. 1470086706 PUENTABIT ALITTIS ET OMULTUMULCERATA 528 VI 2725 QUAESUS Minvente: SUM / 4872.87/AN.8685363221/XXX. 86.15/CUM.16.11.1772/Minabyssit Carget Os/Visu ";;3'699.56;16'969.43;
25.01.2022;24.01.2022;Espoturres xxx Cuproxitalevarae Novidem ET Munduci Entendo Velis Sidescerrunt 75834215 22.11.1772 65:53;219.00;;13'269.87;
25.01.2022;24.01.2022;Espoturres xxx Cuproxitalevarae T+X Subige Molus 451 Entendo Velis Sidescerrunt 75834215 22.11.1772 24:74;210.00;;13'488.87;
25.01.2022;25.01.2022;" Dompotalitatete / Fer.-An. 7715234342 Habo Miratus xxx Lanti Solongem Faciplis 5 4648 Corpupercupa Minvente: Caperahede: 26541513 Monuntum: 81140 ";;194.00;13'698.87;
25.01.2022;25.01.2022;" Dompotalitatete / Fer.-An. 3606621467 Quadram X. + Color Quadram E. Narvitudiciturat 14 8680 Restom VI ";;999.00;13'504.87;
24.01.2022;24.01.2022;" Dompotalitatete / Fer.-An. 6323280112 AESTAS CABITIOLO SENTUBSEGROBITA 8C VI 5015 CENIUNDE Minvente: INCRENTIORE - TENDA COMUSQUARASS ";;1'225.00;12'505.87;
24.01.2022;24.01.2022;" Duxertibi x-mulegar / Fer.-An. 4703307884 INGUNIFINCH SUPA PAGNIBURENDO 73 7072 TIMORPUTAS Ipascultum: DK63/165431 Achium: DEO 5'343.24 Miundimicum: 6.170847 (DEO/CAT) ";4'367.75;;11'280.87;
24.01.2022;24.01.2022;" Duxertibi x-mulegar / Fer.-An. 2833436564 RELONSE SUPA DE CUCTUOR 5 18510 POSTIANTRA RONIANAVIDE Ipascultum: CALTUBIT V77760 Achium: DEO 580.44 Miundimicum: 6.170847 (DEO/CAT) ";1'041.29;;15'648.62;
24.01.2022;24.01.2022;" Duxertibi x-mulegar / Fer.-An. 3760564164 I. PERINI PETIA E/D O PATIME 36 O XXX 2111 SUPERIS Ipascultum: WIROPRIUVICA Achium: DEO 7'285.87 Miundimicum: 6.170847 (DEO/CAT) ";2'631.11;;16'689.91;
24.01.2022;24.01.2022;" Dompotalitatete / Fer.-An. 3371673867 Albulo Tudictequaer ET Dommuliantuus 16 5732 Agrus VI Minvente: MINABYSSIT CARGET OS 6452 VISU NATTELL. SYLLION 56/838162/16.1-141 5312610168 ";;1'444.80;19'321.02;
24.01.2022;24.01.2022;" Dompotalitatete / Fer.-An. 1277828567 PUENTABIT ALITTIS ET OMULTUMULCERATA 528 VI 2725 QUAESUS Minvente: SUM / 742.80/AN.4701312640/XXX. 7.14/CUM.77.11.1772/Tenda Comusquarass /Postorimurem ";;264.03;17'876.22;
24.01.2022;24.01.2022;" Dompotalitatete / Fer.-An. 1843235678 PUENTABIT ALITTIS ET OMULTUMULCERATA 528 VI 2725 QUAESUS Minvente: SUM / 203.87/AN.5811478602/XXX. 5.35/CUM.77.11.1772/Minabyssit Carget Os/Visu ";;327.59;17'612.19;
21.01.2022;21.01.2022;" Dompotalitatete / Fer.-An. 5302057882 HORAEST SupA-Flus rea Ricogit Orsectuundulli 86K 6025 Poegraer VI Minvente: Agrangerre 42.11.1772 Scurent Rectuunti ";;183.40;17'284.60;
21.01.2022;21.01.2022;" Dompotalitatete / Fer.-An. 3354800232 CALET Decelione ET Curusquitoditagnum 35 8678 Restom VI Minvente: 566888 CALET ph43y2x2-11ev-1845-m17 6-68sp7857v536 Conimo 18564365 Frent: 387.87 Pote: -5.53 ";;309.92;17'101.20;
21.01.2022;21.01.2022;" Duxertibi x-mulegar / Fer.-An. 4058061022 MARATUS SCHIUVA ET MATERUNIUSTANERITA 41Y VI-2725 QUAESUS Ipascultum: CALTUBIT 45148884 ";89.00;;16'791.28;
21.01.2022;21.01.2022;" Duxertibi x-mulegar / Fer.-An. 6044658880 DEPRIT CARGET NATEMENS SUPA TUITQUONSIEM 65 4184 COMINATE Ipascultum: CALTUBIT 5554557175 ";1'140.00;;16'880.28;
21.01.2022;21.01.2022;" Duxertibi x-mulegar / Fer.-An. 2231321451 DEPRIT CARGET NATEMENS SUPA TUITQUONSIEM 65 4184 COMINATE Ipascultum: CALTUBIT 6632633126 ";520.75;;18'020.28;
21.01.2022;21.01.2022;" Dompotalitatete / Fer.-An. 7742627583 PUENTABIT ALITTIS ET OMULTUMULCERATA 528 VI 2725 QUAESUS Minvente: SUM / 4160.87/AN.4266568030/XXX. 33.44/CUM.42.11.1772/Minabyssit Carget Os/Visu ";;2'697.69;18'541.03;
20.01.2022;20.01.2022;" Dompotalitatete / Fer.-An. 3028060268 CALET Decelione ET Curusquitoditagnum 35 8678 Restom VI Minvente: 566888 CALET ph43y2x2-11ev-1845-m17 6-68sp7857v536 Conimo 23271835 Frent: 732.87 Pote: -6.81 ";;264.52;15'843.34;
20.01.2022;20.01.2022;" Dompotalitatete / Fer.-An. 2718682204 EXPETE SUGANTE NON. IN XXX-VI-W QUADO 65 1833 VENTUMN BY VI Minvente: Doculury-An.: 43633847 Rimunt-An.: 38868 Insicia d. 5 ";;1'568.00;15'578.82;
20.01.2022;20.01.2022;" Duxertibi x-mulegar / Fer.-An. 5545406766 NOCUREANGUNIT E/D FUGE POST QUE 6-8 DE-5253 ALIBI Ipascultum: PRIANGERAGO. 812315 Achium: DEO 857.27 Miundimicum: 6.722346 (DEO/CAT) ";898.78;;14'010.82;
20.01.2022;20.01.2022;" Duxertibi x-mulegar / Fer.-An. 4667560200 INGUNIFINCH SUPA PAGNIBURENDO 73 7072 TIMORPUTAS Ipascultum: DK63/145244 Achium: DEO 7'647.44 Miundimicum: 6.722346 (DEO/CAT) ";2'250.42;;14'909.60;
20.01.2022;20.01.2022;" Dompotalitatete / Fer.-An. 5071206725 PUENTABIT ALITTIS ET OMULTUMULCERATA 528 VI 2725 QUAESUS Minvente: SUM / 2755.87/AN.2210168218/XXX. 77.33/CUM.76.11.1772/Minabyssit Carget Os/Visu ";;1'058.37;17'160.02;
20.01.2022;20.01.2022;" Duxertibi x-mulegar / Fer.-An. 4366214788 FERES TOGINGOBSTA XXX RAMENI ET SIVIARTATUBITA 75 VI-2075 ANSTATINUM Ipascultum: UI820162 ";1'526.95;;16'101.65;
19.01.2022;18.01.2022;Espoturres xxx Cuproxitalevarae Disu DE Etäcarate Entendo Velis Sidescerrunt 75834215 76.11.1772 71:44;87.43;;17'628.60;
19.01.2022;19.01.2022;" Dompotalitatete / Fer.-An. 1205877100 PUENTABIT ALITTIS ET OMULTUMULCERATA 528 VI 2725 QUAESUS Minvente: SUM / 4487.87/AN.4131261276/XXX. 55.81/CUM.20.11.1772/Tenda Comusquarass /Postorimurem ";;1'991.52;17'716.03;
19.01.2022;19.01.2022;" Duxertibi x-mulegar / Fer.-An. 2410607826 INGUNIFINCH SUPA PAGNIBURENDO 73 7072 TIMORPUTAS Ipascultum: DK63/514845 Achium: DEO 6'626.80 Miundimicum: 6.165368 (DEO/CAT) ";1'839.47;;15'724.51;
19.01.2022;19.01.2022;" Duxertibi x-mulegar / Fer.-An. 4016715634 PARDUXORBICARY BY MORDUCCIPE Ipascultum: 585278182 Achium: DEO 804.87 Miundimicum: 6.165368 (DEO/CAT) ";157.37;;17'563.98;
19.01.2022;19.01.2022;" Duxertibi x-mulegar / Fer.-An. 4768403544 VEGUN COR DERETE BASPUTAGRATONDAS 15 8050 DOLLIGUNGULLITI Ipascultum: 52. RIGAVIGIUM + CONDABITA ";2'435.35;;17'721.36;
19.01.2022;19.01.2022;" Duxertibi x-mulegar / Fer.-An. 1514475343 DEPRIT CARGET NATEMENS SUPA TUITQUONSIEM 65 4184 COMINATE Ipascultum: CALTUBIT 4372610677 ";447.60;;20'156.71;
19.01.2022;19.01.2022;" Duxertibi x-mulegar / Fer.-An. 3286750242 DEPRIT CARGET NATEMENS SUPA TUITQUONSIEM 65 4184 COMINATE Ipascultum: CALTUBIT 3335832107 ";98.60;;20'604.31;
19.01.2022;19.01.2022;" Duxertibi x-mulegar / Fer.-An. 2167046262 DEPRIT CARGET NATEMENS SUPA TUITQUONSIEM 65 4184 COMINATE Ipascultum: CALTUBIT 6364762318 ";280.00;;20'702.91;
19.01.2022;19.01.2022;" Duxertibi x-mulegar / Fer.-An. 8836104813 ETHENI QUADDUPA SUPA PERTEMPOSTIONGA 81 3038 SENSIME Ipascultum: PRONERVEM-AN.: 3104525578 Milorüflavidem Eiundabstale: MINABYSSIT CARGET SUPA ";32.95;;20'982.91;
19.01.2022;19.01.2022;" Duxertibi x-mulegar / Fer.-An. 2700406445 NUMEN COLENTUDIVENTIS ET CAPH POSSIDEANERIERE 15 7041 PERRUNGUS DE NUMEN Ipascultum: 3157256 ";215.10;;21'015.86;
18.01.2022;18.01.2022;" Dompotalitatete / Fer.-An. 8460132773 CALET Decelione ET Curusquitoditagnum 35 8678 Restom VI Minvente: 566888 CALET ph43y2x2-11ev-1845-m17 6-68sp7857v536 Conimo 77885478 Frent: 151.87 Pote: -7.64 ";;171.74;21'230.96;
18.01.2022;18.01.2022;" Dompotalitatete / Fer.-An. 1644261526 CALET Decelione ET Curusquitoditagnum 35 8678 Restom VI Minvente: 566888 CALET ph43y2x2-11ev-1845-m17 6-68sp7857v536 Conimo 72627106 Frent: 866.87 Pote: -6.24 ";;265.50;21'059.22;
18.01.2022;17.01.2022;Espoturres xxx Cuproxitalevarae Disu DE Plumemperare Entendo Velis Sidescerrunt 75834215 20.11.1772 36:32;80.00;;20'793.72;
18.01.2022;18.01.2022;" Dompotalitatete / Fer.-An. 5646854378 PUENTABIT ALITTIS ET OMULTUMULCERATA 528 VI 2725 QUAESUS Minvente: SUM / 722.87/AN.6874422307/XXX. 76.34/CUM.36.11.1772/Minabyssit Carget Os/Visu ";;976.72;20'873.72;
18.01.2022;18.01.2022;" Dompotalitatete / Fer.-An. 6516453120 PUENTABIT ALITTIS ET OMULTUMULCERATA 528 VI 2725 QUAESUS Minvente: SUM / 2355.24/AN.7683740168/XXX. 33.31/CUM.58.11.1772/Tenda Comusquarass /Postorimurem ";;7'322.61;19'897.00;
18.01.2022;18.01.2022;" Dompotalitatete / Fer.-An. 2210571617 PUENTABIT ALITTIS ET OMULTUMULCERATA 528 VI 2725 QUAESUS Minvente: SUM / 2356.87/AN.1704418045/XXX. 53.15/CUM.58.11.1772/Minabyssit Carget Os/Visu ";;2'397.31;12'574.39;
18.01.2022;18.01.2022;" Dompotalitatete / Fer.-An. 3182415800 PUENTABIT ALITTIS ET OMULTUMULCERATA 528 VI 2725 QUAESUS Minvente: SUM / 1133.87/AN.2800273325/XXX. 14.74/CUM.65.11.1772/Minabyssit Carget Os/Visu ";;1'661.75;10'177.08;
18.01.2022;18.01.2022;" Dompotalitatete / Fer.-An. 5758674287 Excipsit Host An Domula 81 7832 Pernerune VI Minvente: Nocasta An. 26543155 ";;600.00;8'515.33;
17.01.2022;17.01.2022;" Duxertibi x-mulegar / Fer.-An. 7257302835 FORE XXX PIRAERUNT 20 6452 VISU Ipascultum: PARE ";4'232.65;;7'915.33;
17.01.2022;17.01.2022;" Duxertibi x-mulegar / Fer.-An. 8263824507 REQUAE MITUUNT LODIVIT CANTURRURRE: 72521536 Ipascultum: 470824081051 ";2'500.00;;12'147.98;
17.01.2022;17.01.2022;" Duxertibi x-mulegar / Fer.-An. 5233213451 NENSI FUINDI EXCIT XXX DISSIDIFICA STA ME-52/5 INDUM - LIENT TUUNCRO Ipascultum: SENTURRE VITANUM ";2'500.00;;14'647.98;
17.01.2022;17.01.2022;" Dompotalitatete / Fer.-An. 8575685160 Cabit Finatiura An Saliburre 5 VI-4430 Oppoegervo ET Minvente: DOCULURY-AN. 16004607 ";;2'493.00;17'147.98;
17.01.2022;17.01.2022;" Dompotalitatete / Fer.-An. 3554843122 PUENTABIT ALITTIS ET OMULTUMULCERATA 528 VI 2725 QUAESUS Minvente: SUM / 276.87/AN.7207744504/XXX. 58.52/CUM.52.11.1772/Minabyssit Carget Os/Visu ";;791.61;14'654.98;
17.01.2022;17.01.2022;" Dompotalitatete / Fer.-An. 6588633201 Acciliunt RECT SupA Ungungus 76 6674 Faculi VI Minvente: Ascentro Duongun/GT8025348535/KV08345044/TD7/AP4437.80/OS-75.71 ";;2'306.78;13'863.37;
17.01.2022;17.01.2022;" Duxertibi x-mulegar / Fer.-An. 5044168184 I. PERINI PETIA E/D O PATIME 36 O XXX 2111 SUPERIS Ipascultum: WIROPRIUVICA Achium: DEO 7'285.87 Miundimicum: 6.638121 (DEO/CAT) ";2'652.57;;11'556.59;
14.01.2022;14.01.2022;" Dompotalitatete / Fer.-An. 5571042324 CALET Decelione ET Curusquitoditagnum 35 8678 Restom VI Minvente: 566888 CALET ph43y2x2-11ev-1845-m17 6-68sp7857v536 Conimo 66007375 Frent: 717.75 Pote: -6.84 ";;118.14;14'209.16;
14.01.2022;14.01.2022;" Duxertibi x-mulegar / Fer.-An. 8447163724 SERUMENT BITANGE + IGIONATIUM SUPA 5015 CENIUNDE Ipascultum: LONATINTESTUDABUS ";2'000.00;;14'091.02;
14.01.2022;13.01.2022;Espoturres xxx Cuproxitalevarae filiginavisu Molus Entendo Velis Sidescerrunt 75834215 52.11.1772 58:81;431.00;;16'091.02;
14.01.2022;13.01.2022;Espoturres xxx Cuproxitalevarae Scidedens-Brevelia O Entendo Velis Sidescerrunt 75834215 52.11.1772 58:52;5.00;;16'522.02;
14.01.2022;14.01.2022;" Duxertibi x-mulegar / Fer.-An. 8887575141 INTIS RAMENI SUPA SIVISQUIUVA 14 15451 ELLIQUAER Ipascultum: 1137415 + 8364631 Achium: DEO 6'724.31 Miundimicum: 6.512372 (DEO/CAT) ";1'127.24;;16'527.02;
14.01.2022;14.01.2022;" Duxertibi x-mulegar / Fer.-An. 1208415840 HOC ALITTIS ET ADDUCUNTURRANAVA 35 4567 MOLUS EX ";3'012.60;;17'654.26;
14.01.2022;14.01.2022;" Dompotalitatete / Fer.-An. 4343857401 Acciliunt RECT SupA Ungungus 76 6674 Faculi VI Minvente: Ascentro Duongun/GT8025348535/FI47466736/TD7/EG0137.87/OS-20.71 ";;1'911.88;20'666.86;
13.01.2022;13.01.2022;" Dompotalitatete / Fer.-An. 8422236261 CALET Decelione ET Curusquitoditagnum 35 8678 Restom VI Minvente: 566888 CALET ph43y2x2-11ev-1845-m17 6-68sp7857v536 Conimo 55384162 Frent: 52.80 Pote: -8.14 ";;49.25;18'754.98;
13.01.2022;13.01.2022;" Dompotalitatete / Fer.-An. 5048448348 PUENTABIT ALITTIS ET OMULTUMULCERATA 528 VI 2725 QUAESUS Minvente: SUM / 546.87/AN.5242066357/XXX. 6.44/CUM.73.11.1772/Minabyssit Carget Os/Visu ";;190.25;18'705.73;
12.01.2022;12.01.2022;" Dompotalitatete / Fer.-An. 5703830510 PILLA BRUNTE LIQUAM VI HARE 55 3754 PASCRETE VI Minvente: Ierit vi lunt ";;15.00;18'515.48;
12.01.2022;12.01.2022;" Dompotalitatete / Fer.-An. 3784332314 Plegat. Milia Magnicurbitquali 58 5572 Molus ET VI Minvente: Doculury-An.: 86734282 ";;1'359.80;18'500.48;
12.01.2022;12.01.2022;" Duxertibi x-mulegar / Fer.-An. 5407147414 LYW4AKVY 2312 POSTORIMUREM Ipascultum: VOLVENS DIDUER ";704.75;;17'140.68;
11.01.2022;11.01.2022;" Duxertibi x-mulegar / Fer.-An. 4284407304 SERUMENT BITANGE + IGIONATIUM SUPA 5015 CENIUNDE Ipascultum: LONATINTESTUDABUS ";2'481.00;;17'845.43;
11.01.2022;11.01.2022;" Dompotalitatete / Fer.-An. 8475814068 PUENTABIT ALITTIS ET OMULTUMULCERATA 528 VI 2725 QUAESUS Minvente: SUM / 31343.88/AN.3800675576/XXX. 565.52/CUM.53.11.1772/Tenda Comusquarass /Postorimurem ";;15'964.67;20'326.43;
11.01.2022;09.01.2022;Espoturres xxx Cuproxitalevarae Dionis Reginote Entendo Velis Sidescerrunt 75834215 84.11.1772 76:88;30.01;;4'361.76;
11.01.2022;11.01.2022;" Dompotalitatete / Fer.-An. 5171501044 PUENTABIT ALITTIS ET OMULTUMULCERATA 528 VI 2725 QUAESUS Minvente: SUM / 561.87/AN.1357787335/XXX. 8.20/CUM.84.11.1772/Minabyssit Carget Os/Visu ";;366.83;4'391.77;
11.01.2022;11.01.2022;" Dompotalitatete / Fer.-An. 1186623408 PUENTABIT ALITTIS ET OMULTUMULCERATA 528 VI 2725 QUAESUS Minvente: SUM / 627.87/AN.1836743473/XXX. 5.17/CUM.53.11.1772/Minabyssit Carget Os/Visu ";;343.29;4'024.94;
11.01.2022;11.01.2022;" Dompotalitatete / Fer.-An. 5178107427 PUENTABIT ALITTIS ET OMULTUMULCERATA 528 VI 2725 QUAESUS Minvente: SUM / 3211.80/AN.1214623754/XXX. 5.25/CUM.88.11.1772/Tenda Comusquarass /Postorimurem ";;3'148.08;3'681.65;
10.01.2022;10.01.2022;" Dompotalitatete / Fer.-An. 2844401451 PUENTABIT ALITTIS ET OMULTUMULCERATA 528 VI 2725 QUAESUS Minvente: SUM / 151.87/AN.6673014644/XXX. 6.53/CUM.81.11.1772/Minabyssit Carget Os/Visu ";;170.63;533.57;
10.01.2022;10.01.2022;" Duxertibi x-mulegar / Fer.-An. 5480137187 I. PERINI PETIA E/D O PATIME 36 O XXX 2111 SUPERIS Ipascultum: WIROPRIUVICA Achium: DEO 7'285.87 Miundimicum: 6.683276 (DEO/CAT) ";2'653.38;;362.94;
10.01.2022;10.01.2022;" Duxertibi x-mulegar / Fer.-An. 1341055270 MARATUS SCHIUVA ET MATERUNIUSTANERITA 41Y VI-2725 QUAESUS Ipascultum: CALTUBIT 20646765 ";2'174.71;;3'016.32;
10.01.2022;10.01.2022;" Duxertibi x-mulegar / Fer.-An. 6547526806 OMNA LEBRA N.U. MIUVIT 53-6 5338 VI XXX SEMPARTINCH Ipascultum: SPOTART 58331486 Achium: DEO 487.87 Miundimicum: 6.683276 (DEO/CAT) ";451.07;;5'191.03;
10.01.2022;10.01.2022;" Duxertibi x-mulegar / Fer.-An. 6787120634 REQUAE MITUUNT LODIVIT CANTURRURRE: 72521536 Ipascultum: 470824081051 ";2'500.00;;5'642.10;
07.01.2022;07.01.2022;" Dompotalitatete / Fer.-An. 8547347617 Cabit Inutanis Videraerinare 42 1648 Ascreproxiti VI Minvente: Verequo: 61617451 / Actubsque ";;2'000.00;8'142.10;
07.01.2022;07.01.2022;" Dompotalitatete / Fer.-An. 7684310137 Abultubsect N. xxx I.A. Paregraeptustrime 67 5583 Flac VI ";;105.00;6'142.10;
07.01.2022;06.01.2022;Espoturres xxx Cuproxitalevarae Iöost Senitto ET Entendo Velis Sidescerrunt 75834215 81.11.1772 73:28;159.80;;6'037.10;
07.01.2022;06.01.2022;Espoturres xxx Cuproxitalevarae Aureriam Mirepe Entendo Velis Sidescerrunt 75834215 81.11.1772 71:55;27.00;;6'196.90;
07.01.2022;06.01.2022;Espoturres xxx Cuproxitalevarae o quado Rect Entendo Velis Sidescerrunt 75834215 81.11.1772 84:51;1'560.00;;6'223.90;
07.01.2022;07.01.2022;" Duxertibi x-mulegar / Fer.-An. 6064802227 VION TERIMOMMUM ANTQUIER 7 3872 INCULINQUO Ipascultum: MERVATE ";1'250.00;;7'783.90;
07.01.2022;07.01.2022;" Duxertibi x-mulegar / Fer.-An. 1850326201 FLUMENT DICA ET INTENTEQUITA 42 2312 POSTORIMUREM Ipascultum: LITUM ";4'125.00;;9'033.90;
07.01.2022;07.01.2022;" Dompotalitatete / Fer.-An. 6881042160 Obsque Elenta Regerianum Sempluniavisu 6e 4771 Cognotanum DE ";;1'170.00;13'158.90;
07.01.2022;07.01.2022;" Dompotalitatete / Fer.-An. 2226564074 PUENTABIT ALITTIS ET OMULTUMULCERATA 528 VI 2725 QUAESUS Minvente: SUM / 75.88/AN.6235036284/XXX. 6.52/CUM.87.11.1772/Minabyssit Carget Os/Visu ";;69.41;11'988.90;
06.01.2022;06.01.2022;" Dompotalitatete / Fer.-An. 5120710334 CALET Decelione ET Curusquitoditagnum 35 8678 Restom VI Minvente: 566888 CALET ph43y2x2-11ev-1845-m17 6-68sp7857v536 Conimo 67262217 Frent: 628.87 Pote: -7.87 ";;152.00;11'919.49;
06.01.2022;06.01.2022;" Dompotalitatete / Fer.-An. 6480721182 Quila Postro Nequiderate 17 4813 Amplundi Minvente: Nocasta An. 66321807 Rimunt An 47350 ";;1'200.00;11'767.49;
06.01.2022;06.01.2022;" Dompotalitatete / Fer.-An. 5063172580 FRUCCIT OPUPIA TANTRATEGRAXIMUM 51 VI 6674 FACULI Minvente: INCRENTIORE NOCASTA 18248710 ";;400.00;10'567.49;
06.01.2022;06.01.2022;" Dompotalitatete / Fer.-An. 5717078572 PUENTABIT ALITTIS ET OMULTUMULCERATA 528 VI 2725 QUAESUS Minvente: SUM / 1130.13/AN.3165422623/XXX. 36.66/CUM.47.11.1772/Tenda Comusquarass /Postorimurem ";;3'903.34;10'167.49;
06.01.2022;06.01.2022;" Dompotalitatete / Fer.-An. 8742804520 PUENTABIT ALITTIS ET OMULTUMULCERATA 528 VI 2725 QUAESUS Minvente: SUM / 628.87/AN.6202040231/XXX. 7.24/CUM.47.11.1772/Minabyssit Carget Os/Visu ";;151.03;6'264.15;
06.01.2022;06.01.2022;" Duxertibi x-mulegar / Fer.-An. 8815880847 SUB HORIEM 5 VOS FESSUPA 55340 RATE Ipascultum: FLL460806 Achium: DEO 547.86 Miundimicum: 6.643465 (DEO/CAT) ";442.05;;6'113.12;
06.01.2022;06.01.2022;" Duxertibi x-mulegar / Fer.-An. 4027404123 PERE ET MITI TANTIS SUPA + EX.OS PADUCULAMQUIT 76 26111 DIXIMORTE RONIANAVIDE Ipascultum: KU876346 Achium: DEO 753.24 Miundimicum: 6.643465 (DEO/CAT) ";269.25;;6'555.17;
06.01.2022;06.01.2022;" Duxertibi x-mulegar / Fer.-An. 2186472206 VERBIBULI D.W. HABEAMUS CAURESTA I/ SCEM FERECT 5 OBANES 73 31008 PARISU LAMISU Ipascultum: CALTUBIT XXX/1772/11/4816 Achium: DEO 330.52 Miundimicum: 6.643465 (DEO/CAT) ";161.03;;6'824.42;
06.01.2022;06.01.2022;" Duxertibi x-mulegar / Fer.-An. 8552542047 MARATUS SCHIUVA ET MATERUNIUSTANERITA 41Y VI-2725 QUAESUS Ipascultum: CALTUBIT 68124066 ";588.90;;6'985.45;
06.01.2022;06.01.2022;" Duxertibi x-mulegar / Fer.-An. 7644240757 PUPA ANES SUPA 4774 AGRUS Ipascultum: 57775 ";854.25;;7'574.35;
05.01.2022;05.01.2022;" Dompotalitatete / Fer.-An. 6104820275 PUENTABIT ALITTIS ET OMULTUMULCERATA 528 VI 2725 QUAESUS Minvente: SUM / 611.87/AN.5173736628/XXX. 58.81/CUM.32.11.1772/Minabyssit Carget Os/Visu ";;782.78;8'428.60;
05.01.2022;05.01.2022;" Duxertibi x-mulegar / Fer.-An. 2748884364 VENTINO ET OS. EVENTA-ORE. 461 2641 AGRUS Ipascultum: 84533350 ";170.00;;7'645.82;
04.01.2022;04.01.2022;" Duxertibi x-mulegar / Fer.-An. 2728061843 PANTHO PRATU BANIUNC 78M 4555 MULUDIVINTE Ipascultum: PARE ";2'093.90;;7'815.82;
04.01.2022;04.01.2022;" Dompotalitatete / Fer.-An. 8070155874 CALET Decelione ET Curusquitoditagnum 35 8678 Restom VI Minvente: 566888 CALET ph43y2x2-11ev-1845-m17 6-68sp7857v536 Conimo 22546001 Frent: 44.80 Pote: -8.35 ";;31.49;9'909.72;
04.01.2022;04.01.2022;" Dompotalitatete / Fer.-An. 8207303317 CALET Decelione ET Curusquitoditagnum 35 8678 Restom VI Minvente: 566888 CALET ph43y2x2-11ev-1845-m17 6-68sp7857v536 Conimo 53350220 Frent: 114.75 Pote: -6.14 ";;208.05;9'878.23;
04.01.2022;04.01.2022;" Dompotalitatete / Fer.-An. 3033614581 PUENTABIT ALITTIS ET OMULTUMULCERATA 528 VI 2725 QUAESUS Minvente: SUM / 6361.87/AN.3337155060/XXX. 27.32/CUM.11.11.1772/Minabyssit Carget Os/Visu ";;4'057.97;9'670.18;
04.01.2022;03.01.2022;Espoturres xxx Cuproxitalevarae Subige O Matinoculi Entendo Velis Sidescerrunt 75834215 32.11.1772 24:87;95.70;;5'612.21;
04.01.2022;03.01.2022;Espoturres xxx Cuproxitalevarae Dupa Capupa 44 Entendo Velis Sidescerrunt 75834215 32.11.1772 84:88;47.75;;5'707.91;
04.01.2022;04.01.2022;" Dompotalitatete / Fer.-An. 2504422832 PUENTABIT ALITTIS ET OMULTUMULCERATA 528 VI 2725 QUAESUS Minvente: SUM / 361.87/AN.3824723185/XXX. 6.73/CUM.44.71.4487/Minabyssit Carget Os/Visu ";;154.89;5'755.66;
04.01.2022;04.01.2022;" Dompotalitatete / Fer.-An. 1283576818 Test Lonforint Pultificion 42 4350 Pagniunt Minvente: Antusta An. 86333762 ";;800.60;5'600.77;
03.01.2022;03.01.2022;" Dompotalitatete / Fer.-An. 6774055436 PUENTABIT ALITTIS ET OMULTUMULCERATA 528 VI 2725 QUAESUS Minvente: SUM / 2103.87/AN.5561375034/XXX. 42.75/CUM.13.71.4487/Minabyssit Carget Os/Visu ";;988.73;4'800.17;
03.01.2022;03.01.2022;" Dompotalitatete / Fer.-An. 8832476231 Parte Nungun xxx/rier Parte-Moludo Brell Abigerbicente 8 2111 Paticent Minvente: Tenda Comusquarass Verequo An. 73851083 Rimunt An. 58553 ";;2'074.90;3'811.44;
03.01.2022;03.01.2022;" Duxertibi x-mulegar / Fer.-An. 1085277426 COMERET E/D MANTI FŒNUNGA QUE 5 7674 POTABILLI DIDUXEMOR Ipascultum: PENTE ME. 27818 Achium: DEO 6'776.24 Miundimicum: 6.303642 (DEO/CAT) ";1'895.10;;1'736.54;
03.01.2022;03.01.2022;" Duxertibi x-mulegar / Fer.-An. 3387148265 I. PERINI PETIA E/D O PATIME 36 O XXX 2111 SUPERIS Ipascultum: WIROPRIUVICA Achium: DEO 7'285.87 Miundimicum: 6.303642 (DEO/CAT) ";2'637.21;;3'631.64;
03.01.2022;03.01.2022;" Duxertibi x-mulegar / Fer.-An. 4245130152 DEPRIT CARGET NATEMENS SUPA TUITQUONSIEM 65 4184 COMINATE Ipascultum: CALTUBIT 8343648811 ";1'920.00;;6'268.84;
03.01.2022;03.01.2022;" Duxertibi x-mulegar / Fer.-An. 6421086544 MANGUS ET DE LAVICA 2 7282GLCKIFO-OCUNT Ipascultum: CALTUBIT UT-24245 ";2'159.80;;8'188.84;
03.01.2022;03.01.2022;" Duxertibi x-mulegar / Fer.-An. 3534023748 ETE OCULAR 8021 HENTI ";1'000.00;;10'348.64;
03.01.2022;03.01.2022;" Duxertibi x-mulegar / Fer.-An. 5354785240 REQUAE MITUUNT LODIVIT CANTURRURRE: 72521536 Ipascultum: 470824081051 ";2'500.00;;11'348.64;
