Buchung,Valuta,Buchungstext,Betrag Detail,Belastung,Gutschrift,Saldo
13.07.2015,13.07.2015,Moregintis�Verriater 444 55:61,,,4'350.00,6'105.28
,,Moregintis�,4'350.00,,,
13.07.2015,13.07.2015,Menetianduperum / Nor.-At. 258750247�MOVESCITE MULI,,,551.85,1'755.28
,,"COMNIUVA-CONE 6�A 38386 PUGANTUM�Puniurem: ME 745200150 ET-NAM 55.51.43�STO LONE 556,87�SIT 1,43 VOS 52�CAUT/PEM 1,67�",551.85,,,
10.07.2015,10.07.2015,Menetianduperum / Nor.-At. 813534101�MOVESCITE MULI,,,101.74,1'203.43
,,"COMNIUVA-CONE 6�A 38386 PUGANTUM�Puniurem: ME 745200150 ET-NAM 56.51.43�STO LONE 216,56�SIT 1,61 VOS 1�CAUT/PEM 1,67�",101.74,,,
10.07.2015,10.07.2015,Semplatas w-quobset / Nor.-At. 211073712�Y.G.M. MULI,,500.00,,1'101.69
,,8412 GEBENSTORF�Mitteilung: TELEFONKARTEN AUFLADEN�,500.00,,,
09.07.2015,09.07.2015,Menetianduperum / Nor.-At. 838161440�MOVESCITE MULI,,,297.45,1'601.69
,,"COMNIUVA-CONE 6�A 38386 PUGANTUM�Puniurem: ME 745200150 ET-NAM 10.51.43�STO LONE 242,37�SIT 1,40 VOS 52�CAUT/PEM 1,67�",297.45,,,
07.07.2015,07.07.2015,Menetianduperum / Nor.-At. 305622171�MOVESCITE MULI,,,151.84,1'304.24
,,"COMNIUVA-CONE 6�A 38386 PUGANTUM�Puniurem: ME 630728424 SI-NAM 20.51.43�STO LONE 884,62�SIT 6,70 VOS 1�CAUT/PEM 1,67�",151.84,,,
07.07.2015,07.07.2015,Menetianduperum / Nor.-At. 202504042�MOVESCITE MULI,,,144.01,1'152.40
,,"COMNIUVA-CONE 6�A 38386 PUGANTUM�Puniurem: ME 731052643 EO-NAM 20.51.43�STO LONE 668,43�SIT 6,37 VOS 8�CAUT/PEM 1,67�",144.01,,,
07.07.2015,07.07.2015,Menetianduperum / Nor.-At. 544015302�MOVESCITE MULI,,,161.82,1'008.39
,,"COMNIUVA-CONE 6�A 38386 PUGANTUM�Puniurem: ME 745200150 ET-NAM 51.51.43�STO LONE 588,47�SIT 1,88 VOS 1�CAUT/PEM 1,67�",161.82,,,
07.07.2015,07.07.2015,Charaddundactum w-quobset�(Saesto Roximerte: 5 / Nor.-At. 322323073),,10'665.00,,846.57
,,Semplatas w-quobset / Nor.-At. 442213265�AEPTION VEMPECTODUCTAS�VESCRESCIONGIT 37�1837 TUBSIVIT�Nittrigero: COVUM 1. C. 4343�,10'530.00,,,
,,Semplatas w-quobset / Nor.-At. 102885551�AEPTION VEMPECTODUCTAS�VESCRESCIONGIT 37�1837 TUBSIVIT�Nittrigero: EX CAPH CALASCERIT�SPIS NUMN�,135.00,,,
06.07.2015,06.07.2015,Moregintis�Verriater 444 37:46,,,9'880.00,11'511.57
,,Moregintis�,9'880.00,,,
06.07.2015,06.07.2015,Menetianduperum / Nor.-At. 467627660�MOVESCITE MULI,,,770.21,1'631.57
,,"COMNIUVA-CONE 6�A 38386 PUGANTUM�Puniurem: ME 745200150 ET-NAM 20.51.43�STO LONE 755,43�SIT 1,71 VOS 78�CAUT/PEM 1,67�",770.21,,,
06.07.2015,06.07.2015,Semplatas / Nor.-At. 817283343�Y.G.M. MULI,,1'500.00,,861.36
,,Nittrigero: MODIRIMIVITAM INCERRES�,1'500.00,,,
03.07.2015,03.07.2015,Moregintis�Verriater 444 34:78,,,1'500.00,2'361.36
,,Moregintis�,1'500.00,,,
03.07.2015,03.07.2015,Menetianduperum / Nor.-At. 218773415�MOVESCITE MULI,,,112.10,861.36
,,"COMNIUVA-CONE 6�A 38386 PUGANTUM�Puniurem: ME 745200150 ET-NAM 12.51.43�STO LONE 187,37�SIT 1,47 VOS 4�CAUT/PEM 1,67�",112.10,,,
02.07.2015,02.07.2015,Menetianduperum / Nor.-At. 768647845�MOVESCITE MULI,,,213.45,749.26
,,"COMNIUVA-CONE 6�A 38386 PUGANTUM�Puniurem: ME 745200150 ET-NAM 30.51.43�STO LONE 487,71�SIT 1,43 VOS 6�CAUT/PEM 1,67�",213.45,,,
01.07.2015,01.07.2015,Menetianduperum / Nor.-At. 837251546�MOVESCITE MULI,,,159.09,535.81
,,"COMNIUVA-CONE 6�A 38386 PUGANTUM�Puniurem: ME 745200150 ET-NAM 86.51.43�STO LONE 536,68�SIT 1,64 VOS 6�CAUT/PEM 1,67�",159.09,,,
30.06.2015,30.06.2015,Sunius que Aut�pere�,,15.00,,376.72
30.06.2015,30.06.2015,Menetianduperum / Nor.-At. 485021861�MOVESCITE MULI,,,68.42,391.72
,,"COMNIUVA-CONE 6�A 38386 PUGANTUM�Puniurem: ME 630728424 SI-NAM 55.20.43�STO LONE 12,56�SIT 1,26 VOS 6�CAUT/PEM 1,67�",68.42,,,
30.06.2015,30.06.2015,Menetianduperum / Nor.-At. 871245737�MOVESCITE MULI,,,59.78,323.30
,,"COMNIUVA-CONE 6�A 38386 PUGANTUM�Puniurem: ME 731052643 EO-NAM 55.20.43�STO LONE 70,47�SIT 1,71 VOS 1�CAUT/PEM 1,67�",59.78,,,
30.06.2015,30.06.2015,Semplatas / Nor.-At. 763857763�Y.G.M. MULI,,500.00,,263.52
,,8412 GEBENSTORF�,500.00,,,
30.06.2015,30.06.2015,Menetianduperum / Nor.-At. 768151886�MOVESCITE MULI,,,188.84,763.52
,,"COMNIUVA-CONE 6�A 38386 PUGANTUM�Puniurem: ME 745200150 ET-NAM 62.20.43�STO LONE 334,37�SIT 1,66 VOS 6�CAUT/PEM 1,67�",188.84,,,
29.06.2015,29.06.2015,Menetianduperum / Nor.-At. 775614204�MOVESCITE MULI,,,532.67,574.68
,,"COMNIUVA-CONE 6�A 38386 PUGANTUM�Puniurem: ME 745200150 ET-NAM 55.20.43�STO LONE 475,45�SIT 1,18 VOS 37�CAUT/PEM 1,67�",532.67,,,
26.06.2015,26.06.2015,Semplatas: Dactuntensus / Nor.-At. 527248864�Aeption Vempectoductas,,120.00,,42.01
,,V�paraliquati 37�1837 A�carit IN�Nittrigero: Iundinvest�,120.00,,,
26.06.2015,26.06.2015,Menetianduperum / Nor.-At. 575252568�MOVESCITE MULI,,,97.00,162.01
,,"COMNIUVA-CONE 6�A 38386 PUGANTUM�Puniurem: ME 745200150 ET-NAM 60.20.43�STO LONE 47,78�SIT 1,78 VOS 4�CAUT/PEM 1,67�",97.00,,,
25.06.2015,25.06.2015,Menetianduperum / Nor.-At. 266032138�MOVESCITE MULI,,,55.85,65.01
,,"COMNIUVA-CONE 6�A 38386 PUGANTUM�Puniurem: ME 745200150 ET-NAM 11.20.43�STO LONE 64,40�SIT 1,71 VOS 6�CAUT/PEM 1,67�",55.85,,,
25.06.2015,25.06.2015,Semplatas w-quobset / Nor.-At. 765484183�Y.G.M. MULI,,300.00,,9.16
,,8412 GEBENSTORF�Mitteilung: TELEFONKARTEN AUFLADEN�,300.00,,,
24.06.2015,24.06.2015,Menetianduperum / Nor.-At. 516263836�MOVESCITE MULI,,,82.40,309.16
,,"COMNIUVA-CONE 6�A 38386 PUGANTUM�Puniurem: ME 745200150 ET-NAM 75.20.43�STO LONE 67,12�SIT 1,62 VOS 1�CAUT/PEM 1,67�",82.40,,,
24.06.2015,24.06.2015,Charaddundactum w-quobset�(Saesto Roximerte: 56 / Nor.-At. 175530220),,10'506.55,,226.76
,,Semplatas w-quobset / Nor.-At. 360605503�F. STATE + POR. IN�APTENDACTIANERUNTI 860�8718 SIRITAM�,2'000.00,,,
,,Semplatas w-quobset / Nor.-At. 121127828�INQUAM CITTIT M.I.�3240 CANTE�,1'264.65,,,
,,Semplatas w-quobset / Nor.-At. 852505105�SERUNUMNIUSTIMEN�7483 VERRIATER�,4'082.10,,,
,,Semplatas w-quobset / Nor.-At. 873828460�FRUMUTIS�GRABIT SECENDACTE IN�2783 SIRITAM�Nittrigero: FACIEIUNTRIUVIVIT 4343�ANT: 2757�TIATEM�SPIS NUMN VERRIATER MULI PISTESCEM�,30.00,,,
,,Semplatas w-quobset / Nor.-At. 573141642�VICULO SCITE IN�NIANTINGINVALUS 670�8718 SIRITAM�,650.90,,,
,,Semplatas w-quobset / Nor.-At. 565173615�BOMIVO SIRITAM�MANTIPTEQUARAE SEPARE�ENT VI�5065 SIRITAM�,120.00,,,
,,Semplatas w-quobset / Nor.-At. 612465308�R.I. TERICUM XXX�SUSTAM�1386 TANNERVUS�Nittrigero: 178051�,66.25,,,
,,Semplatas w-quobset / Nor.-At. 153445004�INQUAM CITTIT M.I.�3240 CANTE�,1'052.95,,,
,,Semplatas w-quobset / Nor.-At. 617851314�PERUM MIRIET OS�4828 CULCHORTUMEDDUM�,435.10,,,
,,Semplatas w-quobset / Nor.-At. 826223552�CULAUT NOMMUS IN�RUCITQUATUR 1�7612 RANTUM OS�,804.60,,,
23.06.2015,23.06.2015,Semplatas w-quobset / Nor.-At. 532282081�XXX COEPE QUE TIATEM BENTIUM,,2'970.00,,10'733.31
,,8046 ZUERICH�,2'970.00,,,
23.06.2015,23.06.2015,Menetianduperum / Nor.-At. 782816257�MOVESCITE MULI,,,214.68,13'703.31
,,"COMNIUVA-CONE 6�A 38386 PUGANTUM�Puniurem: ME 731052643 EO-NAM 52.20.43�STO LONE 757,62�SIT 4,23 VOS 6�CAUT/PEM 1,67�",214.68,,,
23.06.2015,23.06.2015,Menetianduperum / Nor.-At. 423335784�MOVESCITE MULI,,,158.55,13'488.63
,,"COMNIUVA-CONE 6�A 38386 PUGANTUM�Puniurem: ME 630728424 SI-NAM 52.20.43�STO LONE 588,62�SIT 6,10 VOS 4�CAUT/PEM 1,67�",158.55,,,
23.06.2015,23.06.2015,Menetianduperum / Nor.-At. 313256236�MOVESCITE MULI,,,48.92,13'330.08
,,"COMNIUVA-CONE 6�A 38386 PUGANTUM�Puniurem: ME 745200150 ET-NAM 71.20.43�STO LONE 44,56�SIT 1,82 VOS 6�CAUT/PEM 1,67�",48.92,,,
22.06.2015,22.06.2015,Moricitquid: Vit Parduci�Verriater 444 55:51,,,184.68,13'281.16
,,"GRO 265.67, Vada: 1.648�",184.68,,,
22.06.2015,22.06.2015,Moregintis�Verriater 444 55:51,,,6'230.00,13'096.48
,,Moregintis�,6'230.00,,,
22.06.2015,22.06.2015,Menetianduperum / Nor.-At. 567272823�MOVESCITE MULI,,,660.30,6'866.48
,,"COMNIUVA-CONE 6�A 38386 PUGANTUM�Puniurem: ME 745200150 ET-NAM 52.20.43�STO LONE 434,68�SIT 1,78 VOS 55�CAUT/PEM 1,67�",660.30,,,
19.06.2015,19.06.2015,Menetianduperum / Nor.-At. 702663642�MOVESCITE MULI,,,37.91,6'206.18
,,"COMNIUVA-CONE 6�A 38386 PUGANTUM�Puniurem: ME 745200150 ET-NAM 84.20.43�STO LONE 78,40�SIT 1,37 VOS 6�CAUT/PEM 1,67�",37.91,,,
19.06.2015,19.06.2015,Menetianduperum / Nor.-At. 756340356�RERO. SERUNUMNIUSTIMEN,,,1'134.90,6'168.27
,,3000 Bern�EIDG. STEUERVERWALTUNG�BERN�Referenz: No.6053201506170927/0910870 Q03/201�4 RESTGUTHABEN - MWST 0320472415�,1'134.90,,,
18.06.2015,18.06.2015,Moregintis�Verriater 444 87:42,,,4'640.00,5'033.37
,,Moregintis�,4'640.00,,,
18.06.2015,18.06.2015,Menetianduperum / Nor.-At. 850628330�MOVESCITE MULI,,,150.43,393.37
,,"COMNIUVA-CONE 6�A 38386 PUGANTUM�Puniurem: ME 745200150 ET-NAM 82.20.43�STO LONE 381,43�SIT 1,51 VOS 6�CAUT/PEM 1,67�",150.43,,,
17.06.2015,17.06.2015,Menetianduperum / Nor.-At. 126100750�MOVESCITE MULI,,,16.14,242.94
,,"COMNIUVA-CONE 6�A 38386 PUGANTUM�Puniurem: ME 745200150 ET-NAM 15.20.43�STO LONE 87,71�SIT 1,20 VOS 1�CAUT/PEM 1,67�",16.14,,,
16.06.2015,16.06.2015,Menetianduperum / Nor.-At. 865785383�MOVESCITE MULI,,,56.67,226.80
,,"COMNIUVA-CONE 6�A 38386 PUGANTUM�Puniurem: ME 731052643 EO-NAM 43.20.43�STO LONE 71,12�SIT 1,12 VOS 6�CAUT/PEM 1,67�",56.67,,,
16.06.2015,16.06.2015,Menetianduperum / Nor.-At. 702517621�MOVESCITE MULI,,,40.70,170.13
,,"COMNIUVA-CONE 6�A 38386 PUGANTUM�Puniurem: ME 630728424 SI-NAM 43.20.43�STO LONE 63,12�SIT 1,67 VOS 1�CAUT/PEM 1,67�",40.70,,,
16.06.2015,16.06.2015,Menetianduperum / Nor.-At. 148874183�MOVESCITE MULI,,,35.87,129.43
,,"COMNIUVA-CONE 6�A 38386 PUGANTUM�Puniurem: ME 745200150 ET-NAM 87.20.43�STO LONE 61,67�SIT 1,55 VOS 1�CAUT/PEM 1,67�",35.87,,,
16.06.2015,16.06.2015,Semplatas w-quobset / Nor.-At. 607263525�Y.G.M. MULI,,500.00,,93.56
,,8412 GEBENSTORF�Mitteilung: TELEFONKARTEN AUFLADEN�,500.00,,,
15.06.2015,12.06.2015,Semplatas olos Sunius / Nor.-At. 844657546�,,960.00,,593.56
15.06.2015,15.06.2015,Menetianduperum / Nor.-At. 130276718�MOVESCITE MULI,,,548.56,1'553.56
,,"COMNIUVA-CONE 6�A 38386 PUGANTUM�Puniurem: ME 745200150 ET-NAM 43.20.43�STO LONE 370,37�SIT 1,22 VOS 73�CAUT/PEM 1,67�",548.56,,,
12.06.2015,12.06.2015,Menetianduperum / Nor.-At. 777777374�MOVESCITE MULI,,,41.75,1'005.00
,,"COMNIUVA-CONE 6�A 38386 PUGANTUM�Puniurem: ME 745200150 ET-NAM 52.20.43�STO LONE 63,10�SIT 1,43 VOS 6�CAUT/PEM 1,67�",41.75,,,
11.06.2015,11.06.2015,Menetianduperum / Nor.-At. 715801458�MOVESCITE MULI,,,59.34,963.25
,,"COMNIUVA-CONE 6�A 38386 PUGANTUM�Puniurem: ME 745200150 ET-NAM 34.20.43�STO LONE 40,45�SIT 1,10 VOS 4�CAUT/PEM 1,67�",59.34,,,
11.06.2015,11.06.2015,Semplatas w-quobset / Nor.-At. 240225184�F. STATE + POR. IN,,2'000.00,,903.91
,,APTENDACTIANERUNTI 860�8718 SIRITAM�,2'000.00,,,
10.06.2015,10.06.2015,Menetianduperum / Nor.-At. 431078116�MOVESCITE MULI,,,26.66,2'903.91
,,"COMNIUVA-CONE 6�A 38386 PUGANTUM�Puniurem: ME 745200150 ET-NAM 56.20.43�STO LONE 60,43�SIT 1,10 VOS 1�CAUT/PEM 1,67�",26.66,,,
09.06.2015,09.06.2015,Menetianduperum / Nor.-At. 111467681�MOVESCITE MULI,,,263.18,2'877.25
,,"COMNIUVA-CONE 6�A 38386 PUGANTUM�Puniurem: ME 731052643 EO-NAM 82.20.43�STO LONE 616,52�SIT 1,34 VOS 43�CAUT/PEM 1,67�",263.18,,,
09.06.2015,09.06.2015,Menetianduperum / Nor.-At. 318364037�MOVESCITE MULI,,,171.43,2'614.07
,,"COMNIUVA-CONE 6�A 38386 PUGANTUM�Puniurem: ME 630728424 SI-NAM 82.20.43�STO LONE 321,68�SIT 4,52 VOS 6�CAUT/PEM 1,67�",171.43,,,
09.06.2015,09.06.2015,Menetianduperum / Nor.-At. 122653767�MOVESCITE MULI,,,146.29,2'442.64
,,"COMNIUVA-CONE 6�A 38386 PUGANTUM�Puniurem: ME 745200150 ET-NAM 10.20.43�STO LONE 720,87�SIT 1,42 VOS 4�CAUT/PEM 1,67�",146.29,,,
08.06.2015,08.06.2015,Menetianduperum / Nor.-At. 861116555�MOVESCITE MULI,,,624.45,2'296.35
,,"COMNIUVA-CONE 6�A 38386 PUGANTUM�Puniurem: ME 745200150 ET-NAM 82.20.43�STO LONE 556,68�SIT 1,71 VOS 60�CAUT/PEM 1,67�",624.45,,,
05.06.2015,05.06.2015,Menetianduperum / Nor.-At. 244646820�MOVESCITE MULI,,,670.28,1'671.90
,,"COMNIUVA-CONE 6�A 38386 PUGANTUM�Puniurem: ME 745200150 ET-NAM 40.20.43�STO LONE 874,12�SIT 1,80 VOS 15�CAUT/PEM 1,67�",670.28,,,
05.06.2015,05.06.2015,Semplatas w-quobset / Nor.-At. 573766253�,,2'220.60,,1'001.62
05.06.2015,05.06.2015,Charaddundactum w-quobset�(Saesto Roximerte: 3 / Nor.-At. 817418448),,3'377.60,,3'222.22
,,Semplatas w-quobset / Nor.-At. 106458752�Y.G.M. MULI�4525 VITIOLUNDO�Nittrigero: MODIRIMIVITAM INCERRES�,1'000.00,,,
,,Semplatas w-quobset / Nor.-At. 655560454�COGIT FRAEPROW IN�TEQUARANDUCIA 123�8718 SIRITAM�,976.30,,,
,,Semplatas w-quobset / Nor.-At. 511518082�INQUAM CITTIT M.I.�3240 CANTE�,1'401.30,,,
03.06.2015,03.06.2015,Menetianduperum / Nor.-At. 421673786�MOVESCITE MULI,,,286.03,6'599.82
,,"COMNIUVA-CONE 6�A 38386 PUGANTUM�Puniurem: ME 745200150 ET-NAM 12.20.43�STO LONE 827,40�SIT 1,30 VOS 52�CAUT/PEM 1,67�",286.03,,,
02.06.2015,02.06.2015,Menetianduperum / Nor.-At. 115712561�MOVESCITE MULI,,,83.67,6'313.79
,,"COMNIUVA-CONE 6�A 38386 PUGANTUM�Puniurem: ME 731052643 EO-NAM 86.20.43�STO LONE 52,46�SIT 1,55 VOS 1�CAUT/PEM 1,67�",83.67,,,
02.06.2015,02.06.2015,Menetianduperum / Nor.-At. 311156318�MOVESCITE MULI,,,37.97,6'230.12
,,"COMNIUVA-CONE 6�A 38386 PUGANTUM�Puniurem: ME 630728424 SI-NAM 86.20.43�STO LONE 78,10�SIT 1,55 VOS 6�CAUT/PEM 1,67�",37.97,,,
02.06.2015,02.06.2015,Menetianduperum / Nor.-At. 483376440�MOVESCITE MULI,,,72.50,6'192.15
,,"COMNIUVA-CONE 6�A 38386 PUGANTUM�Puniurem: ME 745200150 ET-NAM 30.20.43�STO LONE 33,43�SIT 1,11 VOS 1�CAUT/PEM 1,67�",72.50,,,
02.06.2015,02.06.2015,Menetianduperum / Nor.-At. 415573028�Cone obar Tote,,,4'900.00,6'119.65
,,"Tiatem Bentium obar Xxx�Coepe�Hortuncrisubent 683�Puniurem: Supa xxx cat Auccerunga freque de O�adducare car Acculebibus, bitino at�y Segroteniae spelecistas.�",4'900.00,,,
01.06.2015,01.06.2015,Menetianduperum / Nor.-At. 436004421�MOVESCITE MULI,,,450.05,1'219.65
,,"COMNIUVA-CONE 6�A 38386 PUGANTUM�Puniurem: ME 745200150 ET-NAM 86.20.43�STO LONE 532,68�SIT 1,46 VOS 84�CAUT/PEM 1,67�",450.05,,,
01.06.2015,01.06.2015,Semplatas w-quobset / Nor.-At. 187702777�Y.G.M. MULI,,500.00,,769.60
,,8412 GEBENSTORF�Mitteilung: TELEFONKARTEN AUFLADEN�,500.00,,,
29.05.2015,29.05.2015,Menetianduperum / Nor.-At. 543530320�MOVESCITE MULI,,,112.85,1'269.60
,,"COMNIUVA-CONE 6�A 38386 PUGANTUM�Puniurem: ME 745200150 ET-NAM 55.40.43�STO LONE 520,11�SIT 1,47 VOS 1�CAUT/PEM 1,67�",112.85,,,
28.05.2015,28.05.2015,Menetianduperum / Nor.-At. 114163828�MOVESCITE MULI,,,78.52,1'156.75
,,"COMNIUVA-CONE 6�A 38386 PUGANTUM�Puniurem: ME 745200150 ET-NAM 80.40.43�STO LONE 82,87�SIT 1,80 VOS 1�CAUT/PEM 1,67�",78.52,,,
28.05.2015,28.05.2015,Semplatas w-quobset / Nor.-At. 600574301�Y.G.M. MULI,,500.00,,1'078.23
,,8412 GEBENSTORF�Mitteilung: TELEFONKARTEN AUFLADEN�,500.00,,,
27.05.2015,27.05.2015,Menetianduperum / Nor.-At. 502768876�MOVESCITE MULI,,,135.42,1'578.23
,,"COMNIUVA-CONE 6�A 38386 PUGANTUM�Puniurem: ME 731052643 EO-NAM 60.40.43�STO LONE 334,47�SIT 1,35 VOS 4�CAUT/PEM 1,67�",135.42,,,
27.05.2015,27.05.2015,Menetianduperum / Nor.-At. 582371153�MOVESCITE MULI,,,54.51,1'442.81
,,"COMNIUVA-CONE 6�A 38386 PUGANTUM�Puniurem: ME 630728424 SI-NAM 60.40.43�STO LONE 45,52�SIT 1,43 VOS 1�CAUT/PEM 1,67�",54.51,,,
27.05.2015,27.05.2015,Menetianduperum / Nor.-At. 265823341�MOVESCITE MULI,,,67.11,1'388.30
,,"COMNIUVA-CONE 6�A 38386 PUGANTUM�Puniurem: ME 745200150 ET-NAM 73.40.43�STO LONE 26,62�SIT 1,84 VOS 6�CAUT/PEM 1,67�",67.11,,,
27.05.2015,27.05.2015,Semplatas w-quobset / Nor.-At. 873572318�INUMNIUS ABULIEM IN,,810.00,,1'321.19
,,INERIGANDUCI 1�7163 TEMPENTUM�,810.00,,,
27.05.2015,27.05.2015,Semplatas w-quobset / Nor.-At. 360460055�INUMNIUS ABULIEM IN,,1'854.85,,2'131.19
,,INERIGANDUCI 1�7163 TEMPENTUM�,1'854.85,,,
27.05.2015,27.05.2015,Semplatas w-quobset / Nor.-At. 485755241�VOS RESCRO,,3'384.00,,3'986.04
,,5001 AARAU�,3'384.00,,,
27.05.2015,27.05.2015,Semplatas: Dactuntensus / Nor.-At. 118345850�Aeption Vempectoductas,,120.00,,7'370.04
,,V�paraliquati 37�1837 A�carit IN�Nittrigero: Iundinvest�,120.00,,,
26.05.2015,26.05.2015,Moregintis�Verriater 444 55:10,,,6'870.00,7'490.04
,,Moregintis�,6'870.00,,,
26.05.2015,22.05.2015,Semplatas olos Sunius / Nor.-At. 654868025�,,1'010.00,,620.04
26.05.2015,26.05.2015,Menetianduperum / Nor.-At. 672651737�MOVESCITE MULI,,,613.18,1'630.04
,,"COMNIUVA-CONE 6�A 38386 PUGANTUM�Puniurem: ME 745200150 ET-NAM 60.40.43�STO LONE 806,78�SIT 1,15 VOS 80�CAUT/PEM 1,67�",613.18,,,
22.05.2015,22.05.2015,Menetianduperum / Nor.-At. 833526468�MOVESCITE MULI,,,11.36,1'016.86
,,"COMNIUVA-CONE 6�A 38386 PUGANTUM�Puniurem: ME 745200150 ET-NAM 52.40.43�STO LONE 34,47�SIT 1,46 VOS 1�CAUT/PEM 1,67�",11.36,,,
21.05.2015,21.05.2015,Menetianduperum / Nor.-At. 578386786�MOVESCITE MULI,,,98.54,1'005.50
,,"COMNIUVA-CONE 6�A 38386 PUGANTUM�Puniurem: ME 745200150 ET-NAM 10.40.43�STO LONE 35,10�SIT 1,61 VOS 1�CAUT/PEM 1,67�",98.54,,,
21.05.2015,21.05.2015,Charaddundactum w-quobset�(Saesto Roximerte: 3 / Nor.-At. 882625365),,2'513.90,,906.96
,,Semplatas w-quobset / Nor.-At. 362304734�MITTEST STRISI ESCRISI�GLASUADESTAVESEX 670�4812 ALIGANDITABO�Nittrigero: EXEMPLUS 754633�,205.20,,,
,,Semplatas w-quobset / Nor.-At. 187662427�XXX FICUBITIUNTEMILE PANITIORTO�PANITIORTO�,1'808.70,,,
,,Semplatas w-quobset / Nor.-At. 414061828�Y.G.M. MULI�4525 VITIOLUNDO�Nittrigero: MODIRIMIVITAM INCERRES�,500.00,,,
20.05.2015,20.05.2015,Menetianduperum / Nor.-At. 888438486�MOVESCITE MULI,,,36.48,3'420.86
,,"COMNIUVA-CONE 6�A 38386 PUGANTUM�Puniurem: ME 745200150 ET-NAM 71.40.43�STO LONE 61,46�SIT 1,52 VOS 1�CAUT/PEM 1,67�",36.48,,,
20.05.2015,20.05.2015,Charaddundactum w-quobset�(Saesto Roximerte: 5 / Nor.-At. 712451788),,2'555.55,,3'384.38
,,Semplatas w-quobset / Nor.-At. 353107834�F. STATE + POR. IN�APTENDACTIANERUNTI 860�8718 SIRITAM�,2'000.00,,,
,,Semplatas w-quobset / Nor.-At. 347578205�INQUAM CITTIT M.I.�3240 CANTE�,555.55,,,
20.05.2015,20.05.2015,Charaddundactum w-quobset�(Saesto Roximerte: 5 / Nor.-At. 513631055),,394.60,,5'939.93
,,Semplatas w-quobset / Nor.-At. 771354854�R.I. TERICUM XXX�SUSTAM�1386 TANNERVUS�Nittrigero: 576207�,87.05,,,
,,Semplatas w-quobset / Nor.-At. 260282361�R.I. TERICUM XXX�SUSTAM�1386 TANNERVUS�Nittrigero: 671080�,307.55,,,
19.05.2015,19.05.2015,Menetianduperum / Nor.-At. 707686455�MOVESCITE MULI,,,60.74,6'334.53
,,"COMNIUVA-CONE 6�A 38386 PUGANTUM�Puniurem: ME 745200150 ET-NAM 84.40.43�STO LONE 46,43�SIT 1,10 VOS 6�CAUT/PEM 1,67�",60.74,,,
19.05.2015,19.05.2015,Menetianduperum / Nor.-At. 342214408�MOVESCITE MULI,,,304.27,6'273.79
,,"COMNIUVA-CONE 6�A 38386 PUGANTUM�Puniurem: ME 630728424 SI-NAM 82.40.43�STO LONE 387,43�SIT 6,61 VOS 4�CAUT/PEM 1,67�",304.27,,,
19.05.2015,19.05.2015,Menetianduperum / Nor.-At. 226858875�MOVESCITE MULI,,,107.39,5'969.52
,,"COMNIUVA-CONE 6�A 38386 PUGANTUM�Puniurem: ME 731052643 EO-NAM 82.40.43�STO LONE 835,43�SIT 1,61 VOS 4�CAUT/PEM 1,67�",107.39,,,
18.05.2015,18.05.2015,Moregintis�Verriater 444 55:88,,,5'000.00,5'862.13
,,Moregintis�,5'000.00,,,
18.05.2015,18.05.2015,Menetianduperum / Nor.-At. 205686181�MOVESCITE MULI,,,307.77,862.13
,,"COMNIUVA-CONE 6�A 38386 PUGANTUM�Puniurem: ME 745200150 ET-NAM 82.40.43�STO LONE 133,52�SIT 1,82 VOS 55�CAUT/PEM 1,67�",307.77,,,
15.05.2015,13.05.2015,Semplatas olos Sunius / Nor.-At. 636617818�,,2'710.00,,554.36
15.05.2015,15.05.2015,Menetianduperum / Nor.-At. 585682524�MOVESCITE MULI,,,372.43,3'264.36
,,"COMNIUVA-CONE 6�A 38386 PUGANTUM�Puniurem: ME 745200150 ET-NAM 43.40.43�STO LONE 444,43�SIT 1,42 VOS 87�CAUT/PEM 1,67�",372.43,,,
13.05.2015,13.05.2015,Menetianduperum / Nor.-At. 210582005�MOVESCITE MULI,,,153.00,2'891.93
,,"COMNIUVA-CONE 6�A 38386 PUGANTUM�Puniurem: ME 745200150 ET-NAM 55.40.43�STO LONE 352,45�SIT 1,45 VOS 4�CAUT/PEM 1,67�",153.00,,,
12.05.2015,12.05.2015,Menetianduperum / Nor.-At. 745311413�MOVESCITE MULI,,,113.74,2'738.93
,,"COMNIUVA-CONE 6�A 38386 PUGANTUM�Puniurem: ME 731052643 EO-NAM 34.40.43�STO LONE 667,67�SIT 1,60 VOS 4�CAUT/PEM 1,67�",113.74,,,
12.05.2015,12.05.2015,Menetianduperum / Nor.-At. 887144237�MOVESCITE MULI,,,69.88,2'625.19
,,"COMNIUVA-CONE 6�A 38386 PUGANTUM�Puniurem: ME 630728424 SI-NAM 34.40.43�STO LONE 66,46�SIT 1,33 VOS 6�CAUT/PEM 1,67�",69.88,,,
12.05.2015,12.05.2015,Menetianduperum / Nor.-At. 127677137�MOVESCITE MULI,,,36.47,2'555.31
,,"COMNIUVA-CONE 6�A 38386 PUGANTUM�Puniurem: ME 745200150 ET-NAM 52.40.43�STO LONE 61,46�SIT 1,55 VOS 1�CAUT/PEM 1,67�",36.47,,,
12.05.2015,12.05.2015,Charaddundactum w-quobset�(Saesto Roximerte: 5 / Nor.-At. 127824388),,3'714.70,,2'518.84
,,Semplatas w-quobset / Nor.-At. 108824821�Y.G.M. MULI�4525 VITIOLUNDO�Nittrigero: MODIRIMIVITAM INCERRES�,500.00,,,
,,Semplatas w-quobset / Nor.-At. 385840872�INSUM DES MULI�CANGOBSECTO 82�3246 PHRIETIURY�,3'214.70,,,
11.05.2015,11.05.2015,Moregintis�Verriater 444 37:12,,,5'500.00,6'233.54
,,Moregintis�,5'500.00,,,
11.05.2015,11.05.2015,Menetianduperum / Nor.-At. 480061771�MOVESCITE MULI,,,342.98,733.54
,,"COMNIUVA-CONE 6�A 38386 PUGANTUM�Puniurem: ME 745200150 ET-NAM 34.40.43�STO LONE 353,71�SIT 1,52 VOS 71�CAUT/PEM 1,67�",342.98,,,
08.05.2015,08.05.2015,Menetianduperum / Nor.-At. 230748763�MOVESCITE MULI,,,35.72,390.56
,,"COMNIUVA-CONE 6�A 38386 PUGANTUM�Puniurem: ME 745200150 ET-NAM 82.40.43�STO LONE 78,52�SIT 1,55 VOS 1�CAUT/PEM 1,67�",35.72,,,
07.05.2015,07.05.2015,Menetianduperum / Nor.-At. 123453004�MOVESCITE MULI,,,30.29,354.84
,,"COMNIUVA-CONE 6�A 38386 PUGANTUM�Puniurem: ME 745200150 ET-NAM 51.40.43�STO LONE 62,47�SIT 1,34 VOS 1�CAUT/PEM 1,67�",30.29,,,
06.05.2015,06.05.2015,Menetianduperum / Nor.-At. 381480261�MOVESCITE MULI,,,49.67,324.55
,,"COMNIUVA-CONE 6�A 38386 PUGANTUM�Puniurem: ME 745200150 ET-NAM 20.40.43�STO LONE 44,52�SIT 1,82 VOS 6�CAUT/PEM 1,67�",49.67,,,
05.05.2015,05.05.2015,Menetianduperum / Nor.-At. 110011752�MOVESCITE MULI,,,72.27,274.88
,,"COMNIUVA-CONE 6�A 38386 PUGANTUM�Puniurem: ME 731052643 EO-NAM 46.40.43�STO LONE 13,37�SIT 1,71 VOS 6�CAUT/PEM 1,67�",72.27,,,
05.05.2015,05.05.2015,Menetianduperum / Nor.-At. 587548100�MOVESCITE MULI,,,37.96,202.61
,,"COMNIUVA-CONE 6�A 38386 PUGANTUM�Puniurem: ME 630728424 SI-NAM 46.40.43�STO LONE 78,10�SIT 1,22 VOS 1�CAUT/PEM 1,67�",37.96,,,
05.05.2015,05.05.2015,Menetianduperum / Nor.-At. 745808076�MOVESCITE MULI,,,162.13,164.65
,,"COMNIUVA-CONE 6�A 38386 PUGANTUM�Puniurem: ME 745200150 ET-NAM 40.40.43�STO LONE 588,12�SIT 1,71 VOS 1�CAUT/PEM 1,67�",162.13,,,
05.05.2015,05.05.2015,Semplatas w-quobset / Nor.-At. 813742637�INUMNIUS ABULIEM IN,,1'876.00,,2.52
,,INERIGANDUCI 1�7163 TEMPENTUM�,1'876.00,,,
05.05.2015,05.05.2015,Charaddundactum w-quobset�(Saesto Roximerte: 5 / Nor.-At. 315321016),,2'500.00,,1'878.52
,,Semplatas w-quobset / Nor.-At. 107376548�F. STATE + POR. IN�APTENDACTIANERUNTI 860�8718 SIRITAM�,2'000.00,,,
,,Semplatas w-quobset / Nor.-At. 200304800�Y.G.M. MULI�4525 VITIOLUNDO�Nittrigero: MODIRIMIVITAM INCERRES�,500.00,,,
05.05.2015,05.05.2015,Charaddundactum w-quobset�(Saesto Roximerte: 5 / Nor.-At. 486274251),,587.85,,4'378.52
,,Semplatas w-quobset / Nor.-At. 138711056�XXX VENTINERIPIGET IN�6201 PANITIORTO�,89.60,,,
,,Semplatas w-quobset / Nor.-At. 236654071�XXX HABO�HORGAVINGUNT IN�5836 SIRITAM�,498.25,,,
05.05.2015,05.05.2015,Charaddundactum w-quobset�(Saesto Roximerte: 5 / Nor.-At. 812140604),,2'752.40,,4'966.37
,,Semplatas w-quobset / Nor.-At. 207150504�XXX VENTINERIPIGET IN�6201 PANITIORTO�,804.50,,,
,,Semplatas w-quobset / Nor.-At. 310272864�XXX VENTINERIPIGET IN�6201 PANITIORTO�,1'481.80,,,
,,Semplatas w-quobset / Nor.-At. 725578052�NUMNIMPLAM NUINCEREM�CONE EORUNT SENTO�7278 TIMUS�,60.80,,,
,,Semplatas w-quobset / Nor.-At. 413340338�MORPENTE IN�2676 PROPERE�,262.10,,,
,,Semplatas w-quobset / Nor.-At. 756245135�TUM IN�DIVENTUNTINO. 71�8647 DUCERATONE�,143.20,,,
04.05.2015,04.05.2015,Moregintis�Verriater 444 55:43,,,6'670.00,7'718.77
,,Moregintis�,6'670.00,,,
04.05.2015,04.05.2015,Menetianduperum / Nor.-At. 664470421�MOVESCITE MULI,,,592.19,1'048.77
,,"COMNIUVA-CONE 6�A 38386 PUGANTUM�Puniurem: ME 745200150 ET-NAM 46.40.43�STO LONE 684,62�SIT 1,34 VOS 71�CAUT/PEM 1,67�",592.19,,,
30.04.2015,30.04.2015,Menetianduperum / Nor.-At. 573554733�MOVESCITE MULI,,,38.36,456.58
,,"COMNIUVA-CONE 6�A 38386 PUGANTUM�Puniurem: ME 745200150 ET-NAM 62.46.43�STO LONE 78,37�SIT 1,37 VOS 1�CAUT/PEM 1,67�",38.36,,,
29.04.2015,29.04.2015,Menetianduperum / Nor.-At. 212886071�MOVESCITE MULI,,,35.02,418.22
,,"COMNIUVA-CONE 6�A 38386 PUGANTUM�Puniurem: ME 745200150 ET-NAM 55.46.43�STO LONE 78,43�SIT 1,55 VOS 1�CAUT/PEM 1,67�",35.02,,,
29.04.2015,29.04.2015,Semplatas w-quobset / Nor.-At. 346031117�AEPTION VEMPECTODUCTAS,,7'020.00,,383.20
,,VESCRESCIONGIT 37�1837 TUBSIVIT�Nittrigero: COVUM 1. C. 4343�,7'020.00,,,
28.04.2015,28.04.2015,Semplatas w-quobset / Nor.-At. 748061588�,,1'820.60,,7'403.20
28.04.2015,28.04.2015,Moregintis�Verriater 444 34:61,,,8'740.00,9'223.80
28.04.2015,28.04.2015,Menetianduperum / Nor.-At. 748430804�MOVESCITE MULI,,,17.57,483.80
,,"COMNIUVA-CONE 6�A 38386 PUGANTUM�Puniurem: ME 630728424 SI-NAM 73.46.43�STO LONE 82,67�SIT 1,10 VOS 1�CAUT/PEM 1,67�",17.57,,,
28.04.2015,28.04.2015,Menetianduperum / Nor.-At. 406884130�MOVESCITE MULI,,,37.22,466.23
,,"COMNIUVA-CONE 6�A 38386 PUGANTUM�Puniurem: ME 745200150 ET-NAM 80.46.43�STO LONE 44,78�SIT 1,55 VOS 1�CAUT/PEM 1,67�",37.22,,,
27.04.2015,27.04.2015,Semplatas: Dactuntensus / Nor.-At. 617838876�Aeption Vempectoductas,,120.00,,429.01
,,V�paraliquati 37�1837 A�carit IN�Nittrigero: Iundinvest�,120.00,,,
27.04.2015,27.04.2015,Menetianduperum / Nor.-At. 171003823�MOVESCITE MULI,,,398.45,549.01
,,"COMNIUVA-CONE 6�A 38386 PUGANTUM�Puniurem: ME 745200150 ET-NAM 73.46.43�STO LONE 417,52�SIT 1,47 VOS 37�CAUT/PEM 1,67�",398.45,,,
24.04.2015,24.04.2015,Menetianduperum / Nor.-At. 272333460�MOVESCITE MULI,,,85.45,150.56
,,"COMNIUVA-CONE 6�A 38386 PUGANTUM�Puniurem: ME 745200150 ET-NAM 75.46.43�STO LONE 52,43�SIT 1,62 VOS 4�CAUT/PEM 1,67�",85.45,,,
24.04.2015,24.04.2015,Semplatas w-quobset / Nor.-At. 552142576�VOS RESCRO,,417.85,,65.11
,,5001 AARAU�,417.85,,,
23.04.2015,23.04.2015,Semplatas w-quobset / Nor.-At. 110710170�AEPTION VEMPECTODUCTAS,,240.00,,482.96
,,VESCRESCIONGIT 37�1837 TUBSIVIT�Nittrigero: COVUM ASCEPAR 4343 + TRISI 4343�SPIS NUMN VERRIATER MULI�,240.00,,,
21.04.2015,21.04.2015,Menetianduperum / Nor.-At. 632320224�MOVESCITE MULI,,,81.22,722.96
,,"COMNIUVA-CONE 6�A 38386 PUGANTUM�Puniurem: ME 731052643 EO-NAM 71.46.43�STO LONE 58,43�SIT 1,55 VOS 4�CAUT/PEM 1,67�",81.22,,,
21.04.2015,21.04.2015,Menetianduperum / Nor.-At. 730314088�MOVESCITE MULI,,,54.46,641.74
,,"COMNIUVA-CONE 6�A 38386 PUGANTUM�Puniurem: ME 630728424 SI-NAM 71.46.43�STO LONE 45,87�SIT 1,43 VOS 1�CAUT/PEM 1,67�",54.46,,,
21.04.2015,21.04.2015,Menetianduperum / Nor.-At. 384787751�MOVESCITE MULI,,,32.64,587.28
,,"COMNIUVA-CONE 6�A 38386 PUGANTUM�Puniurem: ME 745200150 ET-NAM 10.46.43�STO LONE 42,43�SIT 1,34 VOS 1�CAUT/PEM 1,67�",32.64,,,
20.04.2015,20.04.2015,Menetianduperum / Nor.-At. 228860263�MOVESCITE MULI,,,495.71,554.64
,,"COMNIUVA-CONE 6�A 38386 PUGANTUM�Puniurem: ME 745200150 ET-NAM 71.46.43�STO LONE 518,62�SIT 1,71 VOS 43�CAUT/PEM 1,67�",495.71,,,
17.04.2015,17.04.2015,Menetianduperum / Nor.-At. 381838283�MOVESCITE MULI,,,58.79,58.93
,,"COMNIUVA-CONE 6�A 38386 PUGANTUM�Puniurem: ME 745200150 ET-NAM 15.46.43�STO LONE 40,67�SIT 1,10 VOS 6�CAUT/PEM 1,67�",58.79,,,
17.04.2015,17.04.2015,Semplatas w-quobset / Nor.-At. 258535120�Y.G.M. MULI,,919.00,,0.14
,,8412 GEBENSTORF�Mitteilung: TELEFONKARTEN AUFLADEN�,919.00,,,
16.04.2015,16.04.2015,Menetianduperum / Nor.-At. 308337261�MOVESCITE MULI,,,59.39,919.14
,,"COMNIUVA-CONE 6�A 38386 PUGANTUM�Puniurem: ME 745200150 ET-NAM 87.46.43�STO LONE 40,46�SIT 1,10 VOS 6�CAUT/PEM 1,67�",59.39,,,
15.04.2015,15.04.2015,Menetianduperum / Nor.-At. 334230415�MOVESCITE MULI,,,21.02,859.75
,,"COMNIUVA-CONE 6�A 38386 PUGANTUM�Puniurem: ME 745200150 ET-NAM 43.46.43�STO LONE 10,56�SIT 1,82 VOS 1�CAUT/PEM 1,67�",21.02,,,
14.04.2015,14.04.2015,Menetianduperum / Nor.-At. 400672714�MOVESCITE MULI,,,147.91,838.73
,,"COMNIUVA-CONE 6�A 38386 PUGANTUM�Puniurem: ME 731052643 EO-NAM 55.46.43�STO LONE 381,10�SIT 1,10 VOS 1�CAUT/PEM 1,67�",147.91,,,
14.04.2015,14.04.2015,Menetianduperum / Nor.-At. 387877522�MOVESCITE MULI,,,45.48,690.82
,,"COMNIUVA-CONE 6�A 38386 PUGANTUM�Puniurem: ME 630728424 SI-NAM 55.46.43�STO LONE 41,46�SIT 1,52 VOS 6�CAUT/PEM 1,67�",45.48,,,
14.04.2015,14.04.2015,Menetianduperum / Nor.-At. 608383424�MOVESCITE MULI,,,58.14,645.34
,,"COMNIUVA-CONE 6�A 38386 PUGANTUM�Puniurem: ME 745200150 ET-NAM 37.46.43�STO LONE 88,78�SIT 1,10 VOS 4�CAUT/PEM 1,67�",58.14,,,
13.04.2015,13.04.2015,Menetianduperum / Nor.-At. 615730403�MOVESCITE MULI,,,342.84,587.20
,,"COMNIUVA-CONE 6�A 38386 PUGANTUM�Puniurem: ME 745200150 ET-NAM 55.46.43�STO LONE 353,40�SIT 1,10 VOS 15�CAUT/PEM 1,67�",342.84,,,
10.04.2015,10.04.2015,Menetianduperum / Nor.-At. 215755563�MOVESCITE MULI,,,65.91,244.36
,,"COMNIUVA-CONE 6�A 38386 PUGANTUM�Puniurem: ME 745200150 ET-NAM 56.46.43�STO LONE 66,43�SIT 1,75 VOS 4�CAUT/PEM 1,67�",65.91,,,
09.04.2015,09.04.2015,Menetianduperum / Nor.-At. 435358657�MOVESCITE MULI,,,10.26,178.45
,,"COMNIUVA-CONE 6�A 38386 PUGANTUM�Puniurem: ME 745200150 ET-NAM 10.46.43�STO LONE 56,62�SIT 1,46 VOS 1�CAUT/PEM 1,67�",10.26,,,
09.04.2015,09.04.2015,Semplatas w-quobset / Nor.-At. 830181004�Y.G.M. MULI,,1'070.00,,168.19
,,8412 GEBENSTORF�Mitteilung: TELEFONKARTEN AUFLADEN�,1'070.00,,,
08.04.2015,08.04.2015,Menetianduperum / Nor.-At. 442775201�MOVESCITE MULI,,,168.04,1'238.19
,,"COMNIUVA-CONE 6�A 38386 PUGANTUM�Puniurem: ME 731052643 EO-NAM 51.46.43�STO LONE 325,12�SIT 6,66 VOS 8�CAUT/PEM 1,67�",168.04,,,
08.04.2015,08.04.2015,Moregintis�Verriater 444 34:12,,,800.00,1'070.15
07.04.2015,07.04.2015,Menetianduperum / Nor.-At. 285012310�MOVESCITE MULI,,,162.57,270.15
,,"COMNIUVA-CONE 6�A 38386 PUGANTUM�Puniurem: ME 745200150 ET-NAM 51.46.43�STO LONE 820,43�SIT 1,88 VOS 1�CAUT/PEM 1,67�",162.57,,,
02.04.2015,02.04.2015,Menetianduperum / Nor.-At. 142482160�MOVESCITE MULI,,,48.13,107.58
,,"COMNIUVA-CONE 6�A 38386 PUGANTUM�Puniurem: ME 745200150 ET-NAM 30.46.43�STO LONE 61,62�SIT 1,15 VOS 6�CAUT/PEM 1,67�",48.13,,,
01.04.2015,01.04.2015,Semplatas w-quobset / Nor.-At. 604548714�Y.G.M. MULI,,900.00,,59.45
,,8412 GEBENSTORF�Mitteilung: TELEFON KONTENBETRAG AUFLADEN�,900.00,,,
31.03.2015,31.03.2015,Menetianduperum / Nor.-At. 505844242�MOVESCITE MULI,,,5.77,959.45
,,"COMNIUVA-CONE 6�A 38386 PUGANTUM�Puniurem: ME 731052643 EO-NAM 62.12.43�STO LONE 4,56�SIT 1,33 VOS 1�CAUT/PEM 1,67�",5.77,,,
31.03.2015,31.03.2015,Moregintis�Verriater 444 56:84,,,700.00,953.68
31.03.2015,31.03.2015,Menetianduperum / Nor.-At. 125606234�MOVESCITE MULI,,,30.14,253.68
,,"COMNIUVA-CONE 6�A 38386 PUGANTUM�Puniurem: ME 745200150 ET-NAM 37.12.43�STO LONE 62,11�SIT 1,34 VOS 6�CAUT/PEM 1,67�",30.14,,,
30.03.2015,30.03.2015,Menetianduperum / Nor.-At. 655426025�MOVESCITE MULI,,,183.71,223.54
,,"COMNIUVA-CONE 6�A 38386 PUGANTUM�Puniurem: ME 745200150 ET-NAM 62.12.43�STO LONE 862,78�SIT 1,45 VOS 34�CAUT/PEM 1,67�",183.71,,,
27.03.2015,27.03.2015,Semplatas w-quobset / Nor.-At. 188647404�,,1'820.60,,39.83
27.03.2015,27.03.2015,Semplatas: Dactuntensus / Nor.-At. 868436547�Aeption Vempectoductas,,3'630.10,,1'860.43
,,V�paraliquati 37�1837 A�carit IN�Nittrigero: Iundinvest�,3'630.10,,,
25.03.2015,25.03.2015,Moregintis�Verriater 444 56:52,,,5'120.00,5'490.53
09.03.2015,09.03.2015,Menetianduperum / Nor.-At. 427858463�1/XXX VENTINERIPIGET IN,,,67.30,370.53
,,"1/NECIDEO ARANNO-AVATION 47�6/BY/8508 PANITIORTO�Puniurem: 64.440.607, 130616243336�SPIS NUMN VERRIATER MULI�7483 VERRIATER�",67.30,,,
06.03.2015,06.03.2015,Semplatas w-quobset / Nor.-At. 823204306�DIVIT FINTIS,,1'550.00,,303.23
,,5442 FISLISBACH�Mitteilung: RESTILCHER SALAER�,1'550.00,,,
02.03.2015,02.03.2015,Semplatas: Dactuntensus / Nor.-At. 236658385�Aeption Vempectoductas,,3'510.10,,1'853.23
,,V�paraliquati 37�1837 A�carit IN�Nittrigero: Iundinvest�,3'510.10,,,
02.03.2015,02.03.2015,Semplatas: Dactuntensus / Nor.-At. 678804138�Divit Fintis,,4'000.00,,5'363.33
,,Sex�at�noctusica 11�4037 Hiurbitube�Nittrigero: Amireriarino�,4'000.00,,,
02.03.2015,02.03.2015,Moregintis�Verriater 444 34:37,,,6'763.23,9'363.33
11.02.2015,11.02.2015,Menetianduperum / Nor.-At. 352188742�1/XXX VENTINERIPIGET IN,,,2'567.00,2'600.10
,,1/NECIDEO ARANNO-AVATION 47�6/BY/8508 PANITIORTO�Puniurem: FERUNGUISICO�JUBSENT APH 10.86.4343�43.688.243/1201/A18JVSL�,2'567.00,,,
28.01.2015,28.01.2015,Semplatas: Dactuntensus / Nor.-At. 470014727�Aeption Vempectoductas,,3'510.10,,33.10
,,V�paraliquati 37�1837 A�carit IN�Nittrigero: Iundinvest�,3'510.10,,,
28.01.2015,28.01.2015,Semplatas: Dactuntensus / Nor.-At. 357750807�Divit Fintis,,4'000.00,,3'543.20
,,Sex�at�noctusica 11�4037 Hiurbitube�Nittrigero: Amireriarino�,4'000.00,,,
28.01.2015,28.01.2015,Atuunnertabstae�Cone �si�t Tiatem,,,7'500.00,7'543.20
28.01.2015,29.01.2015,"Terucirurrunge: 180154310, 80.86.43�Quaecis-Sione Inneriant�eo",,30.00,,43.20
28.01.2015,29.01.2015,"Terucirurrunge: 510635173, 80.86.43�Quaecis-Sione Inneriant�eo",,30.00,,73.20
