Buchung;Valuta;Buchungstext;Belastung;Gutschrift;Saldo CHF;
31.12.2022;31.12.2022;Expettribentemüin RIT Parte Silevolone Mulirate ****************1343 37.54.4118 - 31.31.4118;8.00;;114'955.96;
31.12.2022;31.12.2022;Expettribentemüin RIT Parte Silevolone Mulirate ****************6404 37.54.4118 - 31.31.4118;8.00;;114'963.96;
31.12.2022;31.12.2022;Manareüstuieiuneüin Gulaturidix 3711.1051.8233 37.54.4118 - 15.31.4118;9.00;;114'971.96;
31.12.2022;31.12.2022;Umutabittimpus;355.20;;114'980.96;
31.12.2022;31.12.2022;Aeprormivemilicapicili;107.39;;115'336.16;
30.12.2022;30.12.2022;" Tusidedescurunt / Sta.-An. 6140707721 VoloNerigem VI ";;115.48;115'443.55;
30.12.2022;30.12.2022;" Tusidedescurunt / Sta.-An. 4474586703 BONUM Secriduor VI ";;76.99;115'328.07;
30.12.2022;30.12.2022;" Tusidedescurunt / Sta.-An. 3468558023 DECTUENEM CULCEAT VI ";;8'935.17;115'251.08;
30.12.2022;30.12.2022;" Tusidedescurunt / Sta.-An. 4542558401 DECTUENEM CULCEAT VI ";;303.01;106'315.91;
30.12.2022;28.12.2022;Orunarenti sus Morabibruntrarat MINVES *EMI6321070112 327-565-4814;1'000.00;;106'012.90;
30.12.2022;28.12.2022;Orunarenti sus Morabibruntrarat Miuvimor Molvel NEINI VI;96.00;;107'012.90;
30.12.2022;30.12.2022;" Tusidedescurunt / Sta.-An. 6626552771 Cabigna Latuunt ";;7'500.00;107'108.90;
29.12.2022;29.12.2022;" Tusidedescurunt / Sta.-An. 1284723870 Syllium Sertant VI ";;54.89;99'608.90;
29.12.2022;29.12.2022;" Tusidedescurunt / Sta.-An. 3187365700 Syllium Sertant VI ";;39.00;99'554.01;
29.12.2022;29.12.2022;" Tusidedescurunt / Sta.-An. 1150635012 Syllium Sertant VI ";;349.00;99'515.01;
29.12.2022;29.12.2022;" Tusidedescurunt / Sta.-An. 5656023248 Syllium Sertant VI ";;49.00;99'166.01;
29.12.2022;29.12.2022;" Tusidedescurunt / Sta.-An. 6682251375 Syllium Sertant VI ";;298.00;99'117.01;
29.12.2022;29.12.2022;" Tusidedescurunt / Sta.-An. 7801254703 Syllium Sertant VI ";;289.00;98'819.01;
29.12.2022;29.12.2022;" Tusidedescurunt / Sta.-An. 5576172558 Syllium Sertant VI ";;39.00;98'530.01;
29.12.2022;29.12.2022;" Tusidedescurunt / Sta.-An. 2472706347 Syllium Sertant VI ";;289.00;98'491.01;
29.12.2022;29.12.2022;" Tusidedescurunt / Sta.-An. 8508824344 Syllium Sertant VI ";;109.00;98'202.01;
29.12.2022;29.12.2022;" Tusidedescurunt / Sta.-An. 1404104720 Syllium Sertant VI ";;59.00;98'093.01;
29.12.2022;29.12.2022;" Tusidedescurunt / Sta.-An. 8734435013 Syllium Sertant VI ";;158.00;98'034.01;
29.12.2022;29.12.2022;" Tusidedescurunt / Sta.-An. 4074187368 Syllium Sertant VI ";;209.00;97'876.01;
29.12.2022;29.12.2022;" Tusidedescurunt / Sta.-An. 5205808650 VoloNerigem VI ";;449.77;97'667.01;
29.12.2022;29.12.2022;" Tusidedescurunt / Sta.-An. 3117050062 BONUM Secriduor VI ";;78.96;97'217.24;
29.12.2022;29.12.2022;" Peramente v-chorope / Sta.-An. 3277760435 MALEST ALIDUM POSTRAGO ";3'543.65;;97'138.28;
28.12.2022;28.12.2022;" Tusidedescurunt / Sta.-An. 8661341716 BONUM Secriduor VI ";;60.20;100'681.93;
28.12.2022;28.12.2022;" Tusidedescurunt / Sta.-An. 8105831645 MUNAM COLUVA ";;172.25;100'621.73;
28.12.2022;28.12.2022;" Tusidedescurunt / Sta.-An. 2758183527 BONUM Secriduor VI ";;97.71;100'449.48;
28.12.2022;23.12.2022;Orunarenti sus Morabibruntrarat MINVES *EMI6321070112 327-565-4814;1'000.00;;100'351.77;
28.12.2022;23.12.2022;Orunarenti sus Morabibruntrarat aquissimagna Neini 13 Neini VI;14.95;;101'351.77;
28.12.2022;23.12.2022;Orunarenti sus Morabibruntrarat Conest DEO Neini Neini VI;17.80;;101'366.72;
28.12.2022;28.12.2022;" Tusidedescurunt / Sta.-An. 4301376731 BONUM Secriduor VI ";;123.37;101'384.52;
28.12.2022;28.12.2022;" Tusidedescurunt / Sta.-An. 5735657738 DECTUENEM CULCEAT VI ";;48.01;101'261.15;
28.12.2022;28.12.2022;" Tusidedescurunt / Sta.-An. 4652387072 DECTUENEM CULCEAT VI ";;985.06;101'213.14;
28.12.2022;28.12.2022;" Tusidedescurunt / Sta.-An. 8250011513 DECTUENEM CULCEAT VI ";;213.78;100'228.08;
28.12.2022;28.12.2022;" Crememperituunt v-chorope (Comisu Tirumende: 4 / Sta.-An. 5606870677) ";6'609.75;;100'014.30;
28.12.2022;28.12.2022;" Tusidedescurunt / Sta.-An. 1083145532 DECTUENEM CULCEAT VI ";;110.69;106'624.05;
28.12.2022;28.12.2022;" Peramente v-chorope / Sta.-An. 2668428024 ";694.75;;106'513.36;
28.12.2022;28.12.2022;" Tusidedescurunt / Sta.-An. 1320124432 TERIENDIERVA AT ";;2'911.30;107'208.11;
27.12.2022;27.12.2022;" Peramente v-chorope / Sta.-An. 3477852518 ACTUMN COR AGNUNTI DIT NES ";3'262.83;;104'296.81;
27.12.2022;27.12.2022;" Peramente v-chorope / Sta.-An. 7374621133 HARET FERE VI ";523.55;;107'559.64;
27.12.2022;27.12.2022;" Tusidedescurunt / Sta.-An. 6650062708 DECTUENEM CULCEAT VI ";;2'142.39;108'083.19;
27.12.2022;27.12.2022;" Tusidedescurunt / Sta.-An. 8373320721 Seculibum Sigem ";;1'517.00;105'940.80;
26.12.2022;27.12.2022;" Tusidedescurunt / Sta.-An. 3661423851 VoloNerigem VI ";;49.77;104'423.80;
23.12.2022;23.12.2022;" Tusidedescurunt / Sta.-An. 5485438863 Syllium Sertant VI ";;99.00;104'374.03;
23.12.2022;23.12.2022;" Tusidedescurunt / Sta.-An. 4087314024 Syllium Sertant VI ";;65.00;104'275.03;
23.12.2022;23.12.2022;" Tusidedescurunt / Sta.-An. 8035248446 Syllium Sertant VI ";;49.00;104'210.03;
23.12.2022;23.12.2022;" Tusidedescurunt / Sta.-An. 3376137755 Syllium Sertant VI ";;148.00;104'161.03;
23.12.2022;23.12.2022;" Tusidedescurunt / Sta.-An. 1748174714 Syllium Sertant VI ";;29.00;104'013.03;
23.12.2022;23.12.2022;" Tusidedescurunt / Sta.-An. 3047470613 Syllium Sertant VI ";;99.00;103'984.03;
23.12.2022;23.12.2022;" Tusidedescurunt / Sta.-An. 1872203226 Syllium Sertant VI ";;99.00;103'885.03;
23.12.2022;23.12.2022;" Tusidedescurunt / Sta.-An. 4704115612 Syllium Sertant VI ";;469.00;103'786.03;
23.12.2022;23.12.2022;" Tusidedescurunt / Sta.-An. 7310716682 Syllium Sertant VI ";;169.00;103'317.03;
23.12.2022;23.12.2022;" Tusidedescurunt / Sta.-An. 6705123688 Syllium Sertant VI ";;89.00;103'148.03;
23.12.2022;23.12.2022;" Tusidedescurunt / Sta.-An. 8675267422 Syllium Sertant VI ";;418.00;103'059.03;
23.12.2022;23.12.2022;" Tusidedescurunt / Sta.-An. 5450443714 DECTUENEM CULCEAT VI ";;1'587.08;102'641.03;
23.12.2022;23.12.2022;" Crememperituunt v-chorope (Comisu Tirumende: 5 / Sta.-An. 1767085770) ";5'316.10;;101'053.95;
22.12.2022;22.12.2022;" Tusidedescurunt / Sta.-An. 8320507056 Syllium Sertant VI ";;34.89;106'370.05;
22.12.2022;22.12.2022;" Tusidedescurunt / Sta.-An. 6350085133 Syllium Sertant VI ";;79.00;106'335.16;
22.12.2022;22.12.2022;" Tusidedescurunt / Sta.-An. 6864802708 Syllium Sertant VI ";;49.00;106'256.16;
22.12.2022;22.12.2022;" Tusidedescurunt / Sta.-An. 3022151485 Syllium Sertant VI ";;89.00;106'207.16;
22.12.2022;22.12.2022;" Tusidedescurunt / Sta.-An. 5181768454 Syllium Sertant VI ";;49.00;106'118.16;
22.12.2022;22.12.2022;" Tusidedescurunt / Sta.-An. 5043682485 Syllium Sertant VI ";;99.00;106'069.16;
22.12.2022;22.12.2022;" Tusidedescurunt / Sta.-An. 7350374208 Syllium Sertant VI ";;65.00;105'970.16;
22.12.2022;22.12.2022;" Tusidedescurunt / Sta.-An. 8305703562 Syllium Sertant VI ";;59.00;105'905.16;
22.12.2022;22.12.2022;" Tusidedescurunt / Sta.-An. 5625611324 Syllium Sertant VI ";;79.00;105'846.16;
22.12.2022;22.12.2022;" Tusidedescurunt / Sta.-An. 6661781574 Syllium Sertant VI ";;99.00;105'767.16;
22.12.2022;22.12.2022;" Tusidedescurunt / Sta.-An. 4786737550 Syllium Sertant VI ";;409.00;105'668.16;
22.12.2022;22.12.2022;" Tusidedescurunt / Sta.-An. 2175756701 Syllium Sertant VI ";;109.00;105'259.16;
22.12.2022;22.12.2022;" Tusidedescurunt / Sta.-An. 7752235581 VoloNerigem VI ";;156.83;105'150.16;
22.12.2022;22.12.2022;" Tusidedescurunt / Sta.-An. 5858028106 BONUM Secriduor VI ";;81.92;104'993.33;
22.12.2022;22.12.2022;" Tusidedescurunt / Sta.-An. 5820713354 MUNAM COLUVA ";;172.25;104'911.41;
22.12.2022;22.12.2022;" Tusidedescurunt / Sta.-An. 6636755033 TERIENDIERVA AT ";;1'917.10;104'739.16;
22.12.2022;22.12.2022;" Tusidedescurunt / Sta.-An. 8211354515 TERIENDIERVA AT ";;629.74;102'822.06;
22.12.2022;20.12.2022;Orunarenti sus Morabibruntrarat MINVES *EMI6321070112 327-565-4814;1'000.00;;102'192.32;
22.12.2022;22.12.2022;" Tusidedescurunt / Sta.-An. 4001422352 Dixitquila Parget SegI ";;3'000.00;103'192.32;
22.12.2022;22.12.2022;" Peramente v-chorope / Sta.-An. 6881448062 PRIS M.Q. ";1'586.79;;100'192.32;
21.12.2022;21.12.2022;Expernem-Lento 57861304 - RIT Pier;3'000.00;;101'779.11;
21.12.2022;21.12.2022;" Tusidedescurunt / Sta.-An. 8635674334 Syllium Sertant VI ";;1'148.00;104'779.11;
21.12.2022;21.12.2022;" Tusidedescurunt / Sta.-An. 3316472836 Syllium Sertant VI ";;149.00;103'631.11;
21.12.2022;21.12.2022;" Tusidedescurunt / Sta.-An. 7266370665 Syllium Sertant VI ";;638.99;103'482.11;
21.12.2022;21.12.2022;" Tusidedescurunt / Sta.-An. 5782644827 Syllium Sertant VI ";;99.00;102'843.12;
21.12.2022;21.12.2022;" Tusidedescurunt / Sta.-An. 5431214728 Syllium Sertant VI ";;1'439.00;102'744.12;
21.12.2022;21.12.2022;" Tusidedescurunt / Sta.-An. 1874275273 Syllium Sertant VI ";;99.00;101'305.12;
21.12.2022;21.12.2022;" Tusidedescurunt / Sta.-An. 7660767551 Syllium Sertant VI ";;99.00;101'206.12;
21.12.2022;21.12.2022;" Tusidedescurunt / Sta.-An. 1554512672 Syllium Sertant VI ";;699.01;101'107.12;
21.12.2022;21.12.2022;" Tusidedescurunt / Sta.-An. 6440586004 Syllium Sertant VI ";;779.00;100'408.11;
21.12.2022;21.12.2022;" Tusidedescurunt / Sta.-An. 8211087107 Syllium Sertant VI ";;98.00;99'629.11;
21.12.2022;21.12.2022;" Tusidedescurunt / Sta.-An. 6865018234 Syllium Sertant VI ";;189.00;99'531.11;
21.12.2022;21.12.2022;" Tusidedescurunt / Sta.-An. 4726232436 Syllium Sertant VI ";;32.00;99'342.11;
21.12.2022;21.12.2022;" Tusidedescurunt / Sta.-An. 6666852644 Syllium Sertant VI ";;99.00;99'310.11;
21.12.2022;21.12.2022;" Tusidedescurunt / Sta.-An. 3350050757 Syllium Sertant VI ";;209.00;99'211.11;
21.12.2022;21.12.2022;" Tusidedescurunt / Sta.-An. 1253636200 Syllium Sertant VI ";;45.90;99'002.11;
21.12.2022;21.12.2022;" Tusidedescurunt / Sta.-An. 8065223532 Syllium Sertant VI ";;189.00;98'956.21;
21.12.2022;21.12.2022;" Tusidedescurunt / Sta.-An. 2460660000 Syllium Sertant VI ";;99.00;98'767.21;
21.12.2022;21.12.2022;" Tusidedescurunt / Sta.-An. 6735682443 Syllium Sertant VI ";;99.00;98'668.21;
21.12.2022;21.12.2022;" Tusidedescurunt / Sta.-An. 8540641727 Syllium Sertant VI ";;99.00;98'569.21;
21.12.2022;21.12.2022;" Tusidedescurunt / Sta.-An. 8762881100 Syllium Sertant VI ";;548.00;98'470.21;
21.12.2022;21.12.2022;" Tusidedescurunt / Sta.-An. 1741783721 Syllium Sertant VI ";;159.00;97'922.21;
21.12.2022;21.12.2022;" Tusidedescurunt / Sta.-An. 8810500764 Syllium Sertant VI ";;99.00;97'763.21;
21.12.2022;21.12.2022;" Tusidedescurunt / Sta.-An. 6280626038 Syllium Sertant VI ";;149.00;97'664.21;
21.12.2022;21.12.2022;" Tusidedescurunt / Sta.-An. 5122624753 Syllium Sertant VI ";;409.00;97'515.21;
21.12.2022;21.12.2022;" Tusidedescurunt / Sta.-An. 5027486318 Syllium Sertant VI ";;25.90;97'106.21;
21.12.2022;21.12.2022;" Tusidedescurunt / Sta.-An. 2087834077 Syllium Sertant VI ";;239.00;97'080.31;
21.12.2022;21.12.2022;" Tusidedescurunt / Sta.-An. 4523608332 Syllium Sertant VI ";;49.00;96'841.31;
21.12.2022;21.12.2022;" Tusidedescurunt / Sta.-An. 6181821163 Syllium Sertant VI ";;509.00;96'792.31;
21.12.2022;21.12.2022;" Tusidedescurunt / Sta.-An. 2187662083 Syllium Sertant VI ";;99.00;96'283.31;
21.12.2022;21.12.2022;" Tusidedescurunt / Sta.-An. 7757044862 Syllium Sertant VI ";;59.90;96'184.31;
21.12.2022;21.12.2022;" Tusidedescurunt / Sta.-An. 5165520452 Syllium Sertant VI ";;79.00;96'124.41;
21.12.2022;21.12.2022;" Tusidedescurunt / Sta.-An. 7003350415 Syllium Sertant VI ";;59.00;96'045.41;
21.12.2022;21.12.2022;" Tusidedescurunt / Sta.-An. 6033877608 Syllium Sertant VI ";;70.00;95'986.41;
21.12.2022;21.12.2022;" Tusidedescurunt / Sta.-An. 2002413778 Syllium Sertant VI ";;79.00;95'916.41;
21.12.2022;21.12.2022;" Tusidedescurunt / Sta.-An. 7813277771 BONUM Secriduor VI ";;533.76;95'837.41;
21.12.2022;21.12.2022;" Tusidedescurunt / Sta.-An. 1785471525 DECTUENEM CULCEAT VI ";;751.58;95'303.65;
21.12.2022;21.12.2022;" Tusidedescurunt / Sta.-An. 3440837015 DECTUENEM CULCEAT VI ";;96.10;94'552.07;
21.12.2022;21.12.2022;" Crememperituunt v-chorope (Comisu Tirumende: 4 / Sta.-An. 8374831447) ";2'476.28;;94'455.97;
21.12.2022;21.12.2022;" Peramente v-chorope / Sta.-An. 8366030281 SOLO PLAM SEGI ";678.00;;96'932.25;
20.12.2022;20.12.2022;" Tusidedescurunt / Sta.-An. 1553340184 Perventa Magnis ";;79.90;97'610.25;
20.12.2022;20.12.2022;" Tusidedescurunt / Sta.-An. 8871128856 BONUM Secriduor VI ";;91.39;97'530.35;
20.12.2022;20.12.2022;" Tusidedescurunt / Sta.-An. 5552475834 TERIENDIERVA AT ";;5'151.54;97'438.96;
20.12.2022;20.12.2022;" Tusidedescurunt / Sta.-An. 2261425568 BONUM Secriduor VI ";;432.78;92'287.42;
20.12.2022;16.12.2022;Orunarenti sus Morabibruntrarat MINVES *EMI6321070112 327-565-4814;1'000.00;;91'854.64;
20.12.2022;18.12.2022;Orunarenti sus Morabibruntrarat MINVES *EMI6321070112 in@minves.sta;1'010.80;;92'854.64;
20.12.2022;18.12.2022;Orunarenti sus Morabibruntrarat Sugaré Telliquae AT Putum;26.50;;93'865.44;
20.12.2022;20.12.2022;" Tusidedescurunt / Sta.-An. 8200284358 BONUM Secriduor VI ";;309.62;93'891.94;
20.12.2022;20.12.2022;" Crememperituunt v-chorope (Comisu Tirumende: 4 / Sta.-An. 5850480174) ";1'352.94;;93'582.32;
20.12.2022;20.12.2022;" Crememperituunt v-chorope (Comisu Tirumende: 2 / Sta.-An. 6616525743) ";9'137.64;;94'935.26;
20.12.2022;20.12.2022;" Tusidedescurunt / Sta.-An. 5531853747 DECTUENEM CULCEAT VI ";;5'103.04;104'072.90;
20.12.2022;20.12.2022;" Tusidedescurunt / Sta.-An. 7342162170 DECTUENEM CULCEAT VI ";;76.43;98'969.86;
20.12.2022;20.12.2022;" Tusidedescurunt / Sta.-An. 1461345444 DECTUENEM CULCEAT VI ";;1'521.07;98'893.43;
19.12.2022;19.12.2022;" Secelegitiatuiem (Comisu Tirumende: 7 / Sta.-An. 6680030506) ";;3'700.00;97'372.36;
19.12.2022;19.12.2022;" Tusidedescurunt / Sta.-An. 8182315212 Syllium Sertant VI ";;49.00;93'672.36;
19.12.2022;19.12.2022;" Tusidedescurunt / Sta.-An. 2581678482 Syllium Sertant VI ";;149.00;93'623.36;
19.12.2022;19.12.2022;" Tusidedescurunt / Sta.-An. 4384844367 Syllium Sertant VI ";;99.00;93'474.36;
19.12.2022;19.12.2022;" Tusidedescurunt / Sta.-An. 2240700746 Syllium Sertant VI ";;35.00;93'375.36;
19.12.2022;19.12.2022;" Tusidedescurunt / Sta.-An. 1108187403 Syllium Sertant VI ";;99.00;93'340.36;
19.12.2022;19.12.2022;" Tusidedescurunt / Sta.-An. 2326382266 Syllium Sertant VI ";;54.89;93'241.36;
19.12.2022;19.12.2022;" Tusidedescurunt / Sta.-An. 2563305345 Syllium Sertant VI ";;65.00;93'186.47;
19.12.2022;19.12.2022;" Tusidedescurunt / Sta.-An. 7523114556 Syllium Sertant VI ";;338.00;93'121.47;
19.12.2022;19.12.2022;" Tusidedescurunt / Sta.-An. 5851646060 Syllium Sertant VI ";;19.90;92'783.47;
19.12.2022;19.12.2022;" Tusidedescurunt / Sta.-An. 6533466758 Syllium Sertant VI ";;35.00;92'763.57;
19.12.2022;19.12.2022;" Tusidedescurunt / Sta.-An. 5325030566 Syllium Sertant VI ";;189.00;92'728.57;
19.12.2022;19.12.2022;" Tusidedescurunt / Sta.-An. 5442062842 Syllium Sertant VI ";;49.00;92'539.57;
19.12.2022;19.12.2022;" Tusidedescurunt / Sta.-An. 7076544434 Syllium Sertant VI ";;49.00;92'490.57;
19.12.2022;19.12.2022;" Tusidedescurunt / Sta.-An. 5173233206 Syllium Sertant VI ";;99.00;92'441.57;
19.12.2022;19.12.2022;" Tusidedescurunt / Sta.-An. 6562357435 Syllium Sertant VI ";;99.00;92'342.57;
19.12.2022;19.12.2022;" Tusidedescurunt / Sta.-An. 3423133627 Syllium Sertant VI ";;99.00;92'243.57;
19.12.2022;19.12.2022;" Tusidedescurunt / Sta.-An. 1658243217 Syllium Sertant VI ";;99.00;92'144.57;
19.12.2022;19.12.2022;" Tusidedescurunt / Sta.-An. 3207078125 Syllium Sertant VI ";;49.00;92'045.57;
19.12.2022;19.12.2022;" Tusidedescurunt / Sta.-An. 4633205316 Syllium Sertant VI ";;99.00;91'996.57;
19.12.2022;19.12.2022;" Tusidedescurunt / Sta.-An. 2062635200 Syllium Sertant VI ";;99.00;91'897.57;
19.12.2022;19.12.2022;" Tusidedescurunt / Sta.-An. 3756200155 Syllium Sertant VI ";;1'889.00;91'798.57;
19.12.2022;19.12.2022;" Tusidedescurunt / Sta.-An. 2768535135 Syllium Sertant VI ";;35.00;89'909.57;
19.12.2022;19.12.2022;" Tusidedescurunt / Sta.-An. 7347411216 Syllium Sertant VI ";;39.00;89'874.57;
19.12.2022;19.12.2022;" Tusidedescurunt / Sta.-An. 2730587487 Syllium Sertant VI ";;99.00;89'835.57;
19.12.2022;19.12.2022;" Tusidedescurunt / Sta.-An. 8584467516 Syllium Sertant VI ";;129.00;89'736.57;
19.12.2022;19.12.2022;" Tusidedescurunt / Sta.-An. 2505178217 Syllium Sertant VI ";;249.00;89'607.57;
19.12.2022;19.12.2022;" Tusidedescurunt / Sta.-An. 2217511611 Syllium Sertant VI ";;99.00;89'358.57;
19.12.2022;19.12.2022;" Tusidedescurunt / Sta.-An. 7382810764 Syllium Sertant VI ";;35.00;89'259.57;
19.12.2022;19.12.2022;" Tusidedescurunt / Sta.-An. 2065428535 Syllium Sertant VI ";;35.00;89'224.57;
19.12.2022;19.12.2022;" Tusidedescurunt / Sta.-An. 2452423434 Syllium Sertant VI ";;98.00;89'189.57;
19.12.2022;19.12.2022;" Tusidedescurunt / Sta.-An. 7181541223 Syllium Sertant VI ";;79.80;89'091.57;
19.12.2022;19.12.2022;" Tusidedescurunt / Sta.-An. 5811423232 Syllium Sertant VI ";;298.00;89'011.77;
19.12.2022;19.12.2022;" Tusidedescurunt / Sta.-An. 5174321788 Syllium Sertant VI ";;129.90;88'713.77;
19.12.2022;19.12.2022;" Tusidedescurunt / Sta.-An. 7213746675 Syllium Sertant VI ";;124.00;88'583.87;
19.12.2022;19.12.2022;" Tusidedescurunt / Sta.-An. 6012106312 Syllium Sertant VI ";;62.00;88'459.87;
19.12.2022;19.12.2022;" Tusidedescurunt / Sta.-An. 8241646410 Syllium Sertant VI ";;109.90;88'397.87;
19.12.2022;19.12.2022;" Tusidedescurunt / Sta.-An. 5335323534 Syllium Sertant VI ";;119.00;88'287.97;
19.12.2022;19.12.2022;" Tusidedescurunt / Sta.-An. 5011014186 Syllium Sertant VI ";;349.00;88'168.97;
19.12.2022;19.12.2022;" Tusidedescurunt / Sta.-An. 3360223804 Syllium Sertant VI ";;49.00;87'819.97;
19.12.2022;19.12.2022;" Tusidedescurunt / Sta.-An. 3272042262 Syllium Sertant VI ";;99.00;87'770.97;
19.12.2022;19.12.2022;" Tusidedescurunt / Sta.-An. 1181235553 Syllium Sertant VI ";;99.00;87'671.97;
19.12.2022;19.12.2022;" Tusidedescurunt / Sta.-An. 3631203456 Syllium Sertant VI ";;169.00;87'572.97;
19.12.2022;19.12.2022;" Tusidedescurunt / Sta.-An. 4178680610 Syllium Sertant VI ";;62.00;87'403.97;
19.12.2022;19.12.2022;" Tusidedescurunt / Sta.-An. 3423068868 Syllium Sertant VI ";;49.00;87'341.97;
19.12.2022;19.12.2022;" Tusidedescurunt / Sta.-An. 4340478754 Syllium Sertant VI ";;35.00;87'292.97;
19.12.2022;19.12.2022;" Tusidedescurunt / Sta.-An. 4165245745 Syllium Sertant VI ";;99.00;87'257.97;
19.12.2022;19.12.2022;" Tusidedescurunt / Sta.-An. 6075868525 Syllium Sertant VI ";;69.00;87'158.97;
19.12.2022;19.12.2022;" Tusidedescurunt / Sta.-An. 3502012051 Syllium Sertant VI ";;49.00;87'089.97;
19.12.2022;19.12.2022;" Tusidedescurunt / Sta.-An. 8840227207 Syllium Sertant VI ";;89.00;87'040.97;
19.12.2022;19.12.2022;" Tusidedescurunt / Sta.-An. 6605820044 Syllium Sertant VI ";;35.00;86'951.97;
19.12.2022;19.12.2022;" Tusidedescurunt / Sta.-An. 8748035885 Syllium Sertant VI ";;129.00;86'916.97;
19.12.2022;19.12.2022;" Tusidedescurunt / Sta.-An. 4453075204 Syllium Sertant VI ";;489.00;86'787.97;
19.12.2022;19.12.2022;" Tusidedescurunt / Sta.-An. 6141245281 Syllium Sertant VI ";;99.00;86'298.97;
19.12.2022;19.12.2022;" Tusidedescurunt / Sta.-An. 7148452788 STRICA PUTE ALVENTE J/L ";;6'096.90;86'199.97;
19.12.2022;19.12.2022;" Tusidedescurunt / Sta.-An. 5368484661 DECTUENEM CULCEAT VI ";;2'532.73;80'103.07;
19.12.2022;19.12.2022;" Tusidedescurunt / Sta.-An. 6273837638 DECTUENEM CULCEAT VI ";;1'982.14;77'570.34;
19.12.2022;19.12.2022;" Peramente v-chorope / Sta.-An. 8757255837 PRIS M.Q. ";3'916.84;;75'588.20;
19.12.2022;19.12.2022;" Tusidedescurunt / Sta.-An. 6616637121 VoloNerigem VI ";;38.49;79'505.04;
19.12.2022;19.12.2022;" Tusidedescurunt / Sta.-An. 5745874242 VoloNerigem VI ";;1'204.77;79'466.55;
19.12.2022;19.12.2022;" Tusidedescurunt / Sta.-An. 6415586016 VoloNerigem VI ";;34.28;78'261.78;
16.12.2022;16.12.2022;" Tusidedescurunt / Sta.-An. 3230617084 Syllium Sertant VI ";;99.00;78'227.50;
16.12.2022;16.12.2022;" Tusidedescurunt / Sta.-An. 3620418682 Syllium Sertant VI ";;49.00;78'128.50;
16.12.2022;16.12.2022;" Tusidedescurunt / Sta.-An. 8012818182 Syllium Sertant VI ";;70.00;78'079.50;
16.12.2022;16.12.2022;" Tusidedescurunt / Sta.-An. 4875143348 Syllium Sertant VI ";;559.00;78'009.50;
16.12.2022;16.12.2022;" Tusidedescurunt / Sta.-An. 4483720858 Syllium Sertant VI ";;219.00;77'450.50;
16.12.2022;16.12.2022;" Tusidedescurunt / Sta.-An. 7860572575 Syllium Sertant VI ";;35.00;77'231.50;
16.12.2022;16.12.2022;" Tusidedescurunt / Sta.-An. 6415304500 Syllium Sertant VI ";;559.00;77'196.50;
16.12.2022;16.12.2022;" Tusidedescurunt / Sta.-An. 7864035374 Syllium Sertant VI ";;609.00;76'637.50;
16.12.2022;16.12.2022;" Tusidedescurunt / Sta.-An. 3638225365 Syllium Sertant VI ";;59.90;76'028.50;
16.12.2022;16.12.2022;" Tusidedescurunt / Sta.-An. 8344620812 Syllium Sertant VI ";;99.00;75'968.60;
16.12.2022;16.12.2022;" Tusidedescurunt / Sta.-An. 2361486873 Syllium Sertant VI ";;90.00;75'869.60;
16.12.2022;16.12.2022;" Tusidedescurunt / Sta.-An. 3076578341 Syllium Sertant VI ";;117.00;75'779.60;
16.12.2022;16.12.2022;" Tusidedescurunt / Sta.-An. 7233233315 Syllium Sertant VI ";;99.00;75'662.60;
16.12.2022;16.12.2022;" Tusidedescurunt / Sta.-An. 1805583230 Syllium Sertant VI ";;209.00;75'563.60;
16.12.2022;16.12.2022;" Tusidedescurunt / Sta.-An. 4365714004 Syllium Sertant VI ";;39.00;75'354.60;
16.12.2022;16.12.2022;" Tusidedescurunt / Sta.-An. 7872240458 Syllium Sertant VI ";;169.00;75'315.60;
16.12.2022;16.12.2022;" Tusidedescurunt / Sta.-An. 3388078072 BONUM Secriduor VI ";;193.35;75'146.60;
16.12.2022;14.12.2022;Orunarenti sus Morabibruntrarat MINVES *EMI6321070112 327-565-4814;1'000.00;;74'953.25;
16.12.2022;14.12.2022;Orunarenti sus Morabibruntrarat Pede VI Viäcossus Viäcossus;97.15;;75'953.25;
16.12.2022;16.12.2022;" Peramente v-chorope / Sta.-An. 7814818604 SECTUDUNIAM SEGI ";1'581.59;;76'050.40;
16.12.2022;16.12.2022;" Peramente v-chorope / Sta.-An. 3487234084 HARET FERE VI ";385.80;;77'631.99;
16.12.2022;16.12.2022;" Tusidedescurunt / Sta.-An. 2833638874 DECTUENEM CULCEAT VI ";;1'996.50;78'017.79;
16.12.2022;16.12.2022;" Tusidedescurunt / Sta.-An. 8875678165 DECTUENEM CULCEAT VI ";;347.06;76'021.29;
15.12.2022;15.12.2022;" Tusidedescurunt / Sta.-An. 8665532465 MUNAM COLUVA ";;338.00;75'674.23;
15.12.2022;15.12.2022;" Tusidedescurunt / Sta.-An. 5647022368 VoloNerigem VI ";;15.69;75'336.23;
15.12.2022;15.12.2022;" Tusidedescurunt / Sta.-An. 6300626506 BONUM Secriduor VI ";;607.90;75'320.54;
15.12.2022;15.12.2022;" Tusidedescurunt / Sta.-An. 7405238420 Statte Figentatava SegI ";;1'097.00;74'712.64;
15.12.2022;15.12.2022;" Crememperituunt v-chorope (Comisu Tirumende: 4 / Sta.-An. 3126452007) ";9'280.50;;73'615.64;
15.12.2022;15.12.2022;" Crememperituunt v-chorope (Comisu Tirumende: 4 / Sta.-An. 7364271211) ";19'679.09;;82'896.14;
15.12.2022;15.12.2022;" Peramente v-chorope / Sta.-An. 5376037517 IMULUCENDUSTERE ORTABELINTINUTUS ";4'425.00;;102'575.23;
14.12.2022;14.12.2022;" Tusidedescurunt / Sta.-An. 7054425406 Petaracto B.F. ";;2'925.00;107'000.23;
14.12.2022;14.12.2022;" Tusidedescurunt / Sta.-An. 5006256540 Obita sus Amulia Iniune ";;39.00;104'075.23;
14.12.2022;14.12.2022;" Tusidedescurunt / Sta.-An. 5523662648 Syllium Sertant VI ";;29.00;104'036.23;
14.12.2022;14.12.2022;" Tusidedescurunt / Sta.-An. 2181828176 Syllium Sertant VI ";;129.00;104'007.23;
14.12.2022;14.12.2022;" Tusidedescurunt / Sta.-An. 4357867885 Syllium Sertant VI ";;35.00;103'878.23;
14.12.2022;14.12.2022;" Tusidedescurunt / Sta.-An. 4608665322 Syllium Sertant VI ";;109.00;103'843.23;
14.12.2022;14.12.2022;" Tusidedescurunt / Sta.-An. 6085077424 Syllium Sertant VI ";;189.00;103'734.23;
14.12.2022;14.12.2022;" Tusidedescurunt / Sta.-An. 1758722007 Syllium Sertant VI ";;35.00;103'545.23;
14.12.2022;14.12.2022;" Tusidedescurunt / Sta.-An. 4763016073 Syllium Sertant VI ";;99.00;103'510.23;
14.12.2022;14.12.2022;" Tusidedescurunt / Sta.-An. 1060566402 Syllium Sertant VI ";;35.00;103'411.23;
14.12.2022;14.12.2022;" Tusidedescurunt / Sta.-An. 3771013032 Syllium Sertant VI ";;59.90;103'376.23;
14.12.2022;14.12.2022;" Tusidedescurunt / Sta.-An. 1264604146 Syllium Sertant VI ";;189.00;103'316.33;
14.12.2022;14.12.2022;" Tusidedescurunt / Sta.-An. 5856684854 Syllium Sertant VI ";;59.90;103'127.33;
14.12.2022;14.12.2022;" Tusidedescurunt / Sta.-An. 2835674820 Syllium Sertant VI ";;35.00;103'067.43;
14.12.2022;14.12.2022;" Tusidedescurunt / Sta.-An. 5446762436 Syllium Sertant VI ";;79.00;103'032.43;
14.12.2022;14.12.2022;" Tusidedescurunt / Sta.-An. 4274501506 Syllium Sertant VI ";;35.00;102'953.43;
14.12.2022;14.12.2022;" Tusidedescurunt / Sta.-An. 2283876056 Syllium Sertant VI ";;35.00;102'918.43;
14.12.2022;14.12.2022;" Tusidedescurunt / Sta.-An. 7353678387 Syllium Sertant VI ";;359.00;102'883.43;
14.12.2022;14.12.2022;" Tusidedescurunt / Sta.-An. 3085053781 Syllium Sertant VI ";;99.00;102'524.43;
14.12.2022;14.12.2022;" Tusidedescurunt / Sta.-An. 5362183372 Syllium Sertant VI ";;49.00;102'425.43;
14.12.2022;14.12.2022;" Tusidedescurunt / Sta.-An. 8422717343 Syllium Sertant VI ";;35.00;102'376.43;
14.12.2022;14.12.2022;" Tusidedescurunt / Sta.-An. 8767368581 Syllium Sertant VI ";;539.00;102'341.43;
14.12.2022;14.12.2022;" Tusidedescurunt / Sta.-An. 4217410521 Syllium Sertant VI ";;79.00;101'802.43;
14.12.2022;14.12.2022;" Tusidedescurunt / Sta.-An. 1628056751 Syllium Sertant VI ";;99.00;101'723.43;
14.12.2022;14.12.2022;" Tusidedescurunt / Sta.-An. 8001502171 Syllium Sertant VI ";;35.00;101'624.43;
14.12.2022;14.12.2022;" Tusidedescurunt / Sta.-An. 1368072883 BONUM Secriduor VI ";;455.80;101'589.43;
14.12.2022;14.12.2022;" Tusidedescurunt / Sta.-An. 7415340647 CARAER QUE DIT ";;1'081.60;101'133.63;
14.12.2022;12.12.2022;Orunarenti sus Morabibruntrarat MINVES *EMI6321070112 327-565-4814;1'000.00;;100'052.03;
14.12.2022;14.12.2022;" Crememperituunt v-chorope (Comisu Tirumende: 4 / Sta.-An. 1320664326) ";7'323.87;;101'052.03;
14.12.2022;14.12.2022;" Tusidedescurunt / Sta.-An. 1636657704 DECTUENEM CULCEAT VI ";;38.23;108'375.90;
14.12.2022;14.12.2022;" Tusidedescurunt / Sta.-An. 2287782324 Iniune X. H. sus Iniune F. ";;39.00;108'337.67;
13.12.2022;13.12.2022;" Tusidedescurunt / Sta.-An. 7470584801 BONUM Secriduor VI ";;753.67;108'298.67;
13.12.2022;13.12.2022;" Tusidedescurunt / Sta.-An. 7825774738 VoloNerigem VI ";;28.62;107'545.00;
13.12.2022;13.12.2022;" Tusidedescurunt / Sta.-An. 5513384361 TERIENDIERVA AT ";;1'251.37;107'516.38;
13.12.2022;13.12.2022;" Tusidedescurunt / Sta.-An. 6022787236 BONUM Secriduor VI ";;204.11;106'265.01;
13.12.2022;08.12.2022;Orunarenti sus Morabibruntrarat Nunibullis Conarabo;52.75;;106'060.90;
13.12.2022;10.12.2022;Orunarenti sus Morabibruntrarat MINVES *EMI6321070112 327-565-4814;1'000.00;;106'113.65;
13.12.2022;13.12.2022;" Tusidedescurunt / Sta.-An. 4625006441 BONUM Secriduor VI ";;539.88;107'113.65;
13.12.2022;13.12.2022;" Tusidedescurunt / Sta.-An. 3550203738 DECTUENEM CULCEAT VI ";;111.49;106'573.77;
13.12.2022;13.12.2022;" Tusidedescurunt / Sta.-An. 6340827100 DECTUENEM CULCEAT VI ";;1'471.59;106'462.28;
13.12.2022;13.12.2022;" Tusidedescurunt / Sta.-An. 6530153851 DECTUENEM CULCEAT VI ";;3'381.13;104'990.69;
13.12.2022;13.12.2022;" Tusidedescurunt / Sta.-An. 2561841628 MUM Veneis ";;5'100.00;101'609.56;
12.12.2022;12.12.2022;Expernem-Conumendit 57861304 - RIT Pier;;2'400.00;96'509.56;
12.12.2022;12.12.2022;" Tusidedescurunt / Sta.-An. 4122677386 Syllium Sertant VI ";;39.00;94'109.56;
12.12.2022;12.12.2022;" Tusidedescurunt / Sta.-An. 5287063178 Syllium Sertant VI ";;99.00;94'070.56;
12.12.2022;12.12.2022;" Tusidedescurunt / Sta.-An. 8202636415 Syllium Sertant VI ";;35.00;93'971.56;
12.12.2022;12.12.2022;" Tusidedescurunt / Sta.-An. 8856250463 Syllium Sertant VI ";;99.00;93'936.56;
12.12.2022;12.12.2022;" Tusidedescurunt / Sta.-An. 2767077021 Syllium Sertant VI ";;289.00;93'837.56;
12.12.2022;12.12.2022;" Tusidedescurunt / Sta.-An. 6213613212 Syllium Sertant VI ";;99.00;93'548.56;
12.12.2022;12.12.2022;" Tusidedescurunt / Sta.-An. 8713665731 Syllium Sertant VI ";;49.00;93'449.56;
12.12.2022;12.12.2022;" Tusidedescurunt / Sta.-An. 1837433877 Syllium Sertant VI ";;169.00;93'400.56;
12.12.2022;12.12.2022;" Tusidedescurunt / Sta.-An. 2164305380 Syllium Sertant VI ";;259.00;93'231.56;
12.12.2022;12.12.2022;" Tusidedescurunt / Sta.-An. 7031057802 Syllium Sertant VI ";;309.00;92'972.56;
12.12.2022;12.12.2022;" Tusidedescurunt / Sta.-An. 4350638651 VoloNerigem VI ";;15.69;92'663.56;
12.12.2022;12.12.2022;" Tusidedescurunt / Sta.-An. 8330286464 BONUM Secriduor VI ";;234.61;92'647.87;
12.12.2022;12.12.2022;" Tusidedescurunt / Sta.-An. 3618476558 DECTUENEM CULCEAT VI ";;967.90;92'413.26;
12.12.2022;12.12.2022;" Crememperituunt v-chorope (Comisu Tirumende: 4 / Sta.-An. 5140328758) ";16'989.79;;91'445.36;
12.12.2022;12.12.2022;" Peramente v-chorope / Sta.-An. 6713401253 VENTERE PULO VI ";4'150.00;;108'435.15;
12.12.2022;12.12.2022;" Tusidedescurunt / Sta.-An. 6478138367 Auperit Nateum ";;14.90;112'585.15;
12.12.2022;08.12.2022;Orunarenti sus Morabibruntrarat REA.SOLEVIO.AT SEQUIT;19.00;;112'570.25;
12.12.2022;08.12.2022;Orunarenti sus Morabibruntrarat MINVES *EMI6321070112 327-565-4814;1'000.00;;112'589.25;
09.12.2022;09.12.2022;Expernem-Conumendit 57861304 - RIT Pier;;2'160.00;113'589.25;
09.12.2022;09.12.2022;" Peramente v-chorope / Sta.-An. 3118870841 DIXITQUILA PARGET SEGI ";64.80;;111'429.25;
09.12.2022;09.12.2022;" Tusidedescurunt / Sta.-An. 4438256838 BONUM Secriduor VI ";;686.84;111'494.05;
09.12.2022;06.12.2022;Orunarenti sus Morabibruntrarat REVADEO QUE;957.60;;110'807.21;
09.12.2022;09.12.2022;" Crememperituunt v-chorope (Comisu Tirumende: 4 / Sta.-An. 5261020473) ";2'697.75;;111'764.81;
08.12.2022;08.12.2022;" Tusidedescurunt / Sta.-An. 8605350222 BONUM Secriduor VI ";;409.60;114'462.56;
08.12.2022;06.12.2022;Orunarenti sus Morabibruntrarat MINVES *EMI6321070112 327-565-4814;1'000.00;;114'052.96;
08.12.2022;08.12.2022;" Tusidedescurunt / Sta.-An. 5177172203 DECTUENEM CULCEAT VI ";;2'945.92;115'052.96;
08.12.2022;08.12.2022;" Tusidedescurunt / Sta.-An. 1812110164 DECTUENEM CULCEAT VI ";;2'274.76;112'107.04;
08.12.2022;08.12.2022;" Tusidedescurunt / Sta.-An. 4464430613 Parell. Antubsta Dent ";;947.00;109'832.28;
08.12.2022;08.12.2022;" Peramente v-chorope / Sta.-An. 2315385340 V. AMILIA HIUNT F/B ";2'513.22;;108'885.28;
07.12.2022;07.12.2022;" Secelegitiatuiem (Comisu Tirumende: 7 / Sta.-An. 1161416171) ";;434.30;111'398.50;
07.12.2022;07.12.2022;" Tusidedescurunt / Sta.-An. 7421844187 Syllium Sertant VI ";;59.90;110'964.20;
07.12.2022;07.12.2022;" Tusidedescurunt / Sta.-An. 8322472775 Syllium Sertant VI ";;59.00;110'904.30;
07.12.2022;07.12.2022;" Tusidedescurunt / Sta.-An. 4257848422 Syllium Sertant VI ";;59.90;110'845.30;
07.12.2022;07.12.2022;" Tusidedescurunt / Sta.-An. 3051150416 Syllium Sertant VI ";;29.00;110'785.40;
07.12.2022;07.12.2022;" Tusidedescurunt / Sta.-An. 8316144662 Syllium Sertant VI ";;99.00;110'756.40;
07.12.2022;07.12.2022;" Tusidedescurunt / Sta.-An. 7774302267 Syllium Sertant VI ";;99.00;110'657.40;
07.12.2022;07.12.2022;" Tusidedescurunt / Sta.-An. 2772633868 Syllium Sertant VI ";;199.00;110'558.40;
07.12.2022;07.12.2022;" Tusidedescurunt / Sta.-An. 7115343644 Syllium Sertant VI ";;99.00;110'359.40;
07.12.2022;07.12.2022;" Tusidedescurunt / Sta.-An. 6546788845 Syllium Sertant VI ";;59.90;110'260.40;
07.12.2022;07.12.2022;" Tusidedescurunt / Sta.-An. 5225646658 Syllium Sertant VI ";;79.90;110'200.50;
07.12.2022;07.12.2022;" Tusidedescurunt / Sta.-An. 3201077325 BONUM Secriduor VI ";;391.36;110'120.60;
07.12.2022;07.12.2022;" Tusidedescurunt / Sta.-An. 3465083332 DECTUENEM CULCEAT VI ";;1'344.00;109'729.24;
07.12.2022;07.12.2022;" Tusidedescurunt / Sta.-An. 8801461675 DECTUENEM CULCEAT VI ";;165.74;108'385.24;
07.12.2022;07.12.2022;" Crememperituunt v-chorope (Comisu Tirumende: 4 / Sta.-An. 4550248155) ";1'237.35;;108'219.50;
07.12.2022;07.12.2022;" Crememperituunt v-chorope (Comisu Tirumende: 4 / Sta.-An. 4123042278) ";336.00;;109'456.85;
07.12.2022;07.12.2022;" Tusidedescurunt / Sta.-An. 3002503148 Auperit Rescro ";;100.00;109'792.85;
06.12.2022;06.12.2022;Expernem-Conumendit 57861304 - RIT Pier;;500.00;109'692.85;
06.12.2022;06.12.2022;" Peramente v-chorope / Sta.-An. 5532221267 TERVIDE ELLUVIT B.M.F ";43.72;;109'192.85;
06.12.2022;06.12.2022;" Peramente v-chorope / Sta.-An. 3008735662 CONCELL-TESSE VI ";285.00;;109'236.57;
06.12.2022;06.12.2022;" Tusidedescurunt / Sta.-An. 2431635774 BONUM Secriduor VI ";;594.95;109'521.57;
06.12.2022;06.12.2022;" Tusidedescurunt / Sta.-An. 6054684088 Syllium Sertant VI ";;29.00;108'926.62;
06.12.2022;06.12.2022;" Tusidedescurunt / Sta.-An. 2763423275 Syllium Sertant VI ";;190.00;108'897.62;
06.12.2022;06.12.2022;" Tusidedescurunt / Sta.-An. 3657830627 Syllium Sertant VI ";;99.00;108'707.62;
06.12.2022;06.12.2022;" Tusidedescurunt / Sta.-An. 4350588252 Syllium Sertant VI ";;259.00;108'608.62;
06.12.2022;06.12.2022;" Tusidedescurunt / Sta.-An. 2762362354 Syllium Sertant VI ";;69.00;108'349.62;
06.12.2022;06.12.2022;" Tusidedescurunt / Sta.-An. 4202527071 Syllium Sertant VI ";;99.00;108'280.62;
06.12.2022;06.12.2022;" Tusidedescurunt / Sta.-An. 8854273470 Syllium Sertant VI ";;99.00;108'181.62;
06.12.2022;06.12.2022;" Tusidedescurunt / Sta.-An. 7770683635 Syllium Sertant VI ";;35.00;108'082.62;
06.12.2022;06.12.2022;" Tusidedescurunt / Sta.-An. 5508385318 Syllium Sertant VI ";;609.00;108'047.62;
06.12.2022;06.12.2022;" Tusidedescurunt / Sta.-An. 7044315458 Syllium Sertant VI ";;209.00;107'438.62;
06.12.2022;06.12.2022;" Tusidedescurunt / Sta.-An. 1037631226 Syllium Sertant VI ";;99.00;107'229.62;
06.12.2022;06.12.2022;" Tusidedescurunt / Sta.-An. 1170082684 Syllium Sertant VI ";;99.00;107'130.62;
06.12.2022;06.12.2022;" Tusidedescurunt / Sta.-An. 3206045530 Syllium Sertant VI ";;99.00;107'031.62;
06.12.2022;06.12.2022;" Tusidedescurunt / Sta.-An. 8488762253 Syllium Sertant VI ";;35.00;106'932.62;
06.12.2022;06.12.2022;" Tusidedescurunt / Sta.-An. 4360277613 Syllium Sertant VI ";;169.00;106'897.62;
06.12.2022;06.12.2022;" Tusidedescurunt / Sta.-An. 1135262002 Syllium Sertant VI ";;70.00;106'728.62;
06.12.2022;06.12.2022;" Tusidedescurunt / Sta.-An. 2228355836 Syllium Sertant VI ";;369.00;106'658.62;
06.12.2022;06.12.2022;" Tusidedescurunt / Sta.-An. 1023482866 Syllium Sertant VI ";;1'350.00;106'289.62;
06.12.2022;06.12.2022;" Tusidedescurunt / Sta.-An. 4210521768 Syllium Sertant VI ";;169.00;104'939.62;
06.12.2022;06.12.2022;" Tusidedescurunt / Sta.-An. 3430535384 Syllium Sertant VI ";;249.00;104'770.62;
06.12.2022;06.12.2022;" Tusidedescurunt / Sta.-An. 2828477057 Syllium Sertant VI ";;559.00;104'521.62;
06.12.2022;06.12.2022;" Tusidedescurunt / Sta.-An. 7267677264 Syllium Sertant VI ";;39.00;103'962.62;
06.12.2022;06.12.2022;" Tusidedescurunt / Sta.-An. 3846460670 Syllium Sertant VI ";;189.00;103'923.62;
06.12.2022;06.12.2022;" Tusidedescurunt / Sta.-An. 6506846355 Syllium Sertant VI ";;1'129.00;103'734.62;
06.12.2022;06.12.2022;" Tusidedescurunt / Sta.-An. 8056738623 Syllium Sertant VI ";;99.00;102'605.62;
06.12.2022;06.12.2022;" Tusidedescurunt / Sta.-An. 4358853061 VoloNerigem VI ";;1'121.23;102'506.62;
06.12.2022;06.12.2022;" Tusidedescurunt / Sta.-An. 1657614638 BONUM Secriduor VI ";;304.49;101'385.39;
06.12.2022;06.12.2022;" Tusidedescurunt / Sta.-An. 4512566106 TERIENDIERVA AT ";;1'794.48;101'080.90;
06.12.2022;02.12.2022;Orunarenti sus Morabibruntrarat Pede VI Viäcossus Viäcossus;97.85;;99'286.42;
06.12.2022;03.12.2022;Orunarenti sus Morabibruntrarat MINVES *EMI6321070112 327-565-4814;1'000.00;;99'384.27;
06.12.2022;04.12.2022;Orunarenti sus Morabibruntrarat MINVES *EMI6321070112 327-565-4814;1'000.00;;100'384.27;
06.12.2022;06.12.2022;" Tusidedescurunt / Sta.-An. 8872027885 BONUM Secriduor VI ";;429.24;101'384.27;
06.12.2022;06.12.2022;" Tusidedescurunt / Sta.-An. 6737615304 DECTUENEM CULCEAT VI ";;24.49;100'955.03;
06.12.2022;06.12.2022;" Tusidedescurunt / Sta.-An. 4560682725 DECTUENEM CULCEAT VI ";;2'495.39;100'930.54;
06.12.2022;06.12.2022;" Tusidedescurunt / Sta.-An. 3052007428 DECTUENEM CULCEAT VI ";;5'073.88;98'435.15;
06.12.2022;06.12.2022;" Tusidedescurunt / Sta.-An. 4003744063 DECTUENEM CULCEAT VI ";;161.72;93'361.27;
05.12.2022;05.12.2022;" Tusidedescurunt / Sta.-An. 2746470870 Syllium Sertant VI ";;459.00;93'199.55;
05.12.2022;05.12.2022;" Tusidedescurunt / Sta.-An. 3237062480 Syllium Sertant VI ";;49.00;92'740.55;
05.12.2022;05.12.2022;" Tusidedescurunt / Sta.-An. 2200370561 Syllium Sertant VI ";;35.00;92'691.55;
05.12.2022;05.12.2022;" Tusidedescurunt / Sta.-An. 3482055480 Syllium Sertant VI ";;35.00;92'656.55;
05.12.2022;05.12.2022;" Tusidedescurunt / Sta.-An. 7552835854 Syllium Sertant VI ";;35.00;92'621.55;
05.12.2022;05.12.2022;" Tusidedescurunt / Sta.-An. 3851105102 Syllium Sertant VI ";;99.00;92'586.55;
05.12.2022;05.12.2022;" Tusidedescurunt / Sta.-An. 2351671532 Syllium Sertant VI ";;519.00;92'487.55;
05.12.2022;05.12.2022;" Tusidedescurunt / Sta.-An. 7330110645 Syllium Sertant VI ";;39.00;91'968.55;
05.12.2022;05.12.2022;" Tusidedescurunt / Sta.-An. 1115605504 Syllium Sertant VI ";;59.90;91'929.55;
05.12.2022;05.12.2022;" Tusidedescurunt / Sta.-An. 2718006251 Syllium Sertant VI ";;54.89;91'869.65;
05.12.2022;05.12.2022;" Tusidedescurunt / Sta.-An. 7738662011 Syllium Sertant VI ";;49.00;91'814.76;
05.12.2022;05.12.2022;" Tusidedescurunt / Sta.-An. 8441153124 Syllium Sertant VI ";;19.90;91'765.76;
05.12.2022;05.12.2022;" Tusidedescurunt / Sta.-An. 2304340786 Syllium Sertant VI ";;119.00;91'745.86;
05.12.2022;05.12.2022;" Tusidedescurunt / Sta.-An. 4648408241 Syllium Sertant VI ";;32.90;91'626.86;
05.12.2022;05.12.2022;" Tusidedescurunt / Sta.-An. 4024253247 Syllium Sertant VI ";;70.00;91'593.96;
05.12.2022;05.12.2022;" Tusidedescurunt / Sta.-An. 1138403273 Syllium Sertant VI ";;1'129.00;91'523.96;
05.12.2022;05.12.2022;" Tusidedescurunt / Sta.-An. 3855174678 Syllium Sertant VI ";;1'337.00;90'394.96;
05.12.2022;05.12.2022;" Tusidedescurunt / Sta.-An. 6642003203 Syllium Sertant VI ";;34.89;89'057.96;
05.12.2022;05.12.2022;" Tusidedescurunt / Sta.-An. 7444281264 Syllium Sertant VI ";;868.00;89'023.07;
05.12.2022;05.12.2022;" Tusidedescurunt / Sta.-An. 6608877804 Syllium Sertant VI ";;59.90;88'155.07;
05.12.2022;05.12.2022;" Tusidedescurunt / Sta.-An. 2285553124 Syllium Sertant VI ";;459.00;88'095.17;
05.12.2022;05.12.2022;" Tusidedescurunt / Sta.-An. 4031207442 Syllium Sertant VI ";;1'129.00;87'636.17;
05.12.2022;05.12.2022;" Tusidedescurunt / Sta.-An. 8762578137 Syllium Sertant VI ";;509.00;86'507.17;
05.12.2022;05.12.2022;" Tusidedescurunt / Sta.-An. 1182832687 Syllium Sertant VI ";;29.90;85'998.17;
05.12.2022;05.12.2022;" Tusidedescurunt / Sta.-An. 1655432355 Syllium Sertant VI ";;149.00;85'968.27;
05.12.2022;05.12.2022;" Tusidedescurunt / Sta.-An. 6774818141 Syllium Sertant VI ";;874.00;85'819.27;
05.12.2022;05.12.2022;" Tusidedescurunt / Sta.-An. 2850675103 Syllium Sertant VI ";;528.00;84'945.27;
05.12.2022;05.12.2022;" Tusidedescurunt / Sta.-An. 2765568026 Syllium Sertant VI ";;70.00;84'417.27;
05.12.2022;05.12.2022;" Tusidedescurunt / Sta.-An. 2677221751 Syllium Sertant VI ";;509.00;84'347.27;
05.12.2022;05.12.2022;" Tusidedescurunt / Sta.-An. 1242717428 Syllium Sertant VI ";;99.00;83'838.27;
05.12.2022;05.12.2022;" Tusidedescurunt / Sta.-An. 3403016830 Syllium Sertant VI ";;99.00;83'739.27;
05.12.2022;05.12.2022;" Tusidedescurunt / Sta.-An. 2818580733 VoloNerigem VI ";;122.39;83'640.27;
05.12.2022;05.12.2022;" Tusidedescurunt / Sta.-An. 1213185361 BONUM Secriduor VI ";;592.88;83'517.88;
05.12.2022;05.12.2022;" Tusidedescurunt / Sta.-An. 4460802310 STATULO ELLUTE ";;1'157.00;82'925.00;
05.12.2022;05.12.2022;" Crememperituunt v-chorope (Comisu Tirumende: 2 / Sta.-An. 7761773840) ";5'620.46;;81'768.00;
05.12.2022;05.12.2022;" Tusidedescurunt / Sta.-An. 1532062073 DECTUENEM CULCEAT VI ";;1'259.30;87'388.46;
05.12.2022;05.12.2022;" Tusidedescurunt / Sta.-An. 5874285453 DECTUENEM CULCEAT VI ";;90.58;86'129.16;
05.12.2022;05.12.2022;" Peramente v-chorope / Sta.-An. 3784428120 SIT STAE LIQUAECTE ";4'323.00;;86'038.58;
05.12.2022;05.12.2022;" Tusidedescurunt / Sta.-An. 1228043274 Anterm Quadduxors ";;369.00;90'361.58;
05.12.2022;05.12.2022;" Tusidedescurunt / Sta.-An. 7383380822 VoloNerigem VI ";;1'144.77;89'992.58;
05.12.2022;05.12.2022;" Tusidedescurunt / Sta.-An. 6871332320 VoloNerigem VI ";;28.62;88'847.81;
05.12.2022;05.12.2022;" Tusidedescurunt / Sta.-An. 7275753754 VoloNerigem VI ";;109.57;88'819.19;
05.12.2022;05.12.2022;" Tusidedescurunt / Sta.-An. 7070351368 VoloNerigem VI ";;24.67;88'709.62;
05.12.2022;01.12.2022;Orunarenti sus Morabibruntrarat MINVES *EMI6321070112 327-565-4814;265.45;;88'684.95;
02.12.2022;02.12.2022;" Tusidedescurunt / Sta.-An. 8300822327 BONUM Secriduor VI ";;261.35;88'950.40;
02.12.2022;30.11.2022;Orunarenti sus Morabibruntrarat MINVES *EMI6321070112 327-565-4814;1'000.00;;88'689.05;
02.12.2022;30.11.2022;Orunarenti sus Morabibruntrarat Menti-4117 Pier Pier;29.95;;89'689.05;
02.12.2022;02.12.2022;" Tusidedescurunt / Sta.-An. 5025357458 DECTUENEM CULCEAT VI ";;143.30;89'719.00;
02.12.2022;02.12.2022;" Crememperituunt v-chorope (Comisu Tirumende: 5 / Sta.-An. 2606412858) ";3'952.32;;89'575.70;
01.12.2022;01.12.2022;" Tusidedescurunt / Sta.-An. 6283217151 Ferres SegI ";;479.00;93'528.02;
01.12.2022;01.12.2022;" Tusidedescurunt / Sta.-An. 5151565631 Syllium Sertant VI ";;59.00;93'049.02;
01.12.2022;01.12.2022;" Tusidedescurunt / Sta.-An. 3526512472 Syllium Sertant VI ";;54.89;92'990.02;
01.12.2022;01.12.2022;" Tusidedescurunt / Sta.-An. 3056864255 Syllium Sertant VI ";;209.00;92'935.13;
01.12.2022;01.12.2022;" Tusidedescurunt / Sta.-An. 3562610242 Syllium Sertant VI ";;179.00;92'726.13;
01.12.2022;01.12.2022;" Tusidedescurunt / Sta.-An. 4571106081 Syllium Sertant VI ";;379.00;92'547.13;
01.12.2022;01.12.2022;" Tusidedescurunt / Sta.-An. 8778164480 Syllium Sertant VI ";;49.00;92'168.13;
01.12.2022;01.12.2022;" Tusidedescurunt / Sta.-An. 3830106147 Syllium Sertant VI ";;459.00;92'119.13;
01.12.2022;01.12.2022;" Tusidedescurunt / Sta.-An. 1277735642 Syllium Sertant VI ";;289.00;91'660.13;
01.12.2022;01.12.2022;" Tusidedescurunt / Sta.-An. 2451674810 VoloNerigem VI ";;198.77;91'371.13;
01.12.2022;01.12.2022;" Tusidedescurunt / Sta.-An. 5457476300 BONUM Secriduor VI ";;1'107.15;91'172.36;
01.12.2022;28.11.2022;Orunarenti sus Morabibruntrarat Unti Tentam AT Pectom ET;157.40;;90'065.21;
01.12.2022;01.12.2022;" Tusidedescurunt / Sta.-An. 5164442821 DECTUENEM CULCEAT VI ";;2'252.29;90'222.61;
01.12.2022;01.12.2022;" Crememperituunt v-chorope (Comisu Tirumende: 4 / Sta.-An. 8671717408) ";2'887.20;;87'970.32;
01.12.2022;01.12.2022;" Peramente v-chorope / Sta.-An. 1704220066 METRO SIT TATER ";5'526.70;;90'857.52;
01.12.2022;01.12.2022;" Peramente v-chorope / Sta.-An. 1720550282 V. AMILIA HIUNT F/B ";2'503.97;;96'384.22;
30.11.2022;30.11.2022;" Tusidedescurunt / Sta.-An. 4115602631 Syllium Sertant VI ";;39.00;98'888.19;
30.11.2022;30.11.2022;" Tusidedescurunt / Sta.-An. 8018003014 Syllium Sertant VI ";;39.00;98'849.19;
30.11.2022;30.11.2022;" Tusidedescurunt / Sta.-An. 4641606570 Syllium Sertant VI ";;35.00;98'810.19;
30.11.2022;30.11.2022;" Tusidedescurunt / Sta.-An. 4280305082 Syllium Sertant VI ";;35.00;98'775.19;
30.11.2022;30.11.2022;" Tusidedescurunt / Sta.-An. 3385753771 Syllium Sertant VI ";;49.00;98'740.19;
30.11.2022;30.11.2022;" Tusidedescurunt / Sta.-An. 4153246884 Syllium Sertant VI ";;35.00;98'691.19;
30.11.2022;30.11.2022;" Tusidedescurunt / Sta.-An. 7585287654 Syllium Sertant VI ";;54.89;98'656.19;
30.11.2022;30.11.2022;" Tusidedescurunt / Sta.-An. 5841152844 Syllium Sertant VI ";;29.90;98'601.30;
30.11.2022;30.11.2022;" Tusidedescurunt / Sta.-An. 8004563613 Syllium Sertant VI ";;35.00;98'571.40;
30.11.2022;30.11.2022;" Tusidedescurunt / Sta.-An. 7163572622 Syllium Sertant VI ";;79.00;98'536.40;
30.11.2022;30.11.2022;" Tusidedescurunt / Sta.-An. 2536165015 Syllium Sertant VI ";;99.00;98'457.40;
30.11.2022;30.11.2022;" Tusidedescurunt / Sta.-An. 7017165085 Syllium Sertant VI ";;99.00;98'358.40;
30.11.2022;30.11.2022;" Tusidedescurunt / Sta.-An. 5451451133 Syllium Sertant VI ";;249.00;98'259.40;
30.11.2022;30.11.2022;" Tusidedescurunt / Sta.-An. 1457117172 Syllium Sertant VI ";;259.00;98'010.40;
30.11.2022;30.11.2022;" Tusidedescurunt / Sta.-An. 5385237350 Syllium Sertant VI ";;99.00;97'751.40;
30.11.2022;30.11.2022;" Tusidedescurunt / Sta.-An. 6627574683 Syllium Sertant VI ";;629.00;97'652.40;
30.11.2022;30.11.2022;" Tusidedescurunt / Sta.-An. 6107816172 Syllium Sertant VI ";;349.00;97'023.40;
30.11.2022;30.11.2022;" Tusidedescurunt / Sta.-An. 8263277774 Syllium Sertant VI ";;609.00;96'674.40;
30.11.2022;30.11.2022;" Tusidedescurunt / Sta.-An. 2802184108 Syllium Sertant VI ";;99.00;96'065.40;
30.11.2022;30.11.2022;" Tusidedescurunt / Sta.-An. 8712834620 Syllium Sertant VI ";;109.00;95'966.40;
30.11.2022;30.11.2022;" Tusidedescurunt / Sta.-An. 1151604542 Syllium Sertant VI ";;169.00;95'857.40;
30.11.2022;30.11.2022;" Tusidedescurunt / Sta.-An. 1807488651 Syllium Sertant VI ";;469.00;95'688.40;
30.11.2022;30.11.2022;" Tusidedescurunt / Sta.-An. 3275546072 Syllium Sertant VI ";;349.00;95'219.40;
30.11.2022;30.11.2022;" Tusidedescurunt / Sta.-An. 5164224523 Syllium Sertant VI ";;169.00;94'870.40;
30.11.2022;30.11.2022;" Tusidedescurunt / Sta.-An. 1625644358 Syllium Sertant VI ";;349.00;94'701.40;
30.11.2022;30.11.2022;" Tusidedescurunt / Sta.-An. 7731387412 Syllium Sertant VI ";;75.00;94'352.40;
30.11.2022;30.11.2022;" Tusidedescurunt / Sta.-An. 1110716041 Syllium Sertant VI ";;99.00;94'277.40;
30.11.2022;30.11.2022;" Tusidedescurunt / Sta.-An. 5268638032 Syllium Sertant VI ";;89.00;94'178.40;
30.11.2022;30.11.2022;" Tusidedescurunt / Sta.-An. 6731605248 Syllium Sertant VI ";;219.00;94'089.40;
30.11.2022;30.11.2022;" Tusidedescurunt / Sta.-An. 3775673071 Syllium Sertant VI ";;99.00;93'870.40;
30.11.2022;30.11.2022;" Tusidedescurunt / Sta.-An. 1241358505 Syllium Sertant VI ";;389.00;93'771.40;
30.11.2022;30.11.2022;" Tusidedescurunt / Sta.-An. 7400777227 Syllium Sertant VI ";;156.00;93'382.40;
30.11.2022;30.11.2022;" Tusidedescurunt / Sta.-An. 4787355154 Syllium Sertant VI ";;189.00;93'226.40;
30.11.2022;30.11.2022;" Tusidedescurunt / Sta.-An. 5864167830 Syllium Sertant VI ";;90.00;93'037.40;
30.11.2022;30.11.2022;" Tusidedescurunt / Sta.-An. 4485004638 BONUM Secriduor VI ";;417.29;92'947.40;
30.11.2022;30.11.2022;" Tusidedescurunt / Sta.-An. 8523131040 TERIENDIERVA AT ";;3'720.60;92'530.11;
30.11.2022;28.11.2022;Orunarenti sus Morabibruntrarat MINVES*EMI6321070112 DOLINTUM;1'000.00;;88'809.51;
30.11.2022;30.11.2022;" Üholvent nem 3711.1051.8222 Dixitquila Parget SegI / Sta.-An. 8414181181 ";1'300.00;;89'809.51;
30.11.2022;30.11.2022;" Peramente v-chorope / Sta.-An. 6453055347 AGO MANTEM.ME SEGI BY. UT ";1'381.09;;91'109.51;
30.11.2022;30.11.2022;" Crememperituunt v-chorope (Comisu Tirumende: 2 / Sta.-An. 3020350368) ";8'138.50;;92'490.60;
30.11.2022;30.11.2022;" Crememperituunt v-chorope (Comisu Tirumende: 41 / Sta.-An. 1111341614) ";7'878.63;;100'629.10;
29.11.2022;29.11.2022;" Secelegitiatuiem (Comisu Tirumende: 7 / Sta.-An. 4652127362) ";;50.00;108'507.73;
29.11.2022;29.11.2022;" Tusidedescurunt / Sta.-An. 1480047218 Syllium Sertant VI ";;79.00;108'457.73;
29.11.2022;29.11.2022;" Tusidedescurunt / Sta.-An. 6773271775 Syllium Sertant VI ";;238.00;108'378.73;
29.11.2022;29.11.2022;" Tusidedescurunt / Sta.-An. 1217765772 Syllium Sertant VI ";;169.00;108'140.73;
29.11.2022;29.11.2022;" Tusidedescurunt / Sta.-An. 6322518823 Syllium Sertant VI ";;35.00;107'971.73;
29.11.2022;29.11.2022;" Tusidedescurunt / Sta.-An. 1045425227 Syllium Sertant VI ";;95.00;107'936.73;
29.11.2022;29.11.2022;" Tusidedescurunt / Sta.-An. 1668021635 Syllium Sertant VI ";;198.00;107'841.73;
29.11.2022;29.11.2022;" Tusidedescurunt / Sta.-An. 4255266741 Syllium Sertant VI ";;349.00;107'643.73;
29.11.2022;29.11.2022;" Tusidedescurunt / Sta.-An. 4328062000 Syllium Sertant VI ";;99.00;107'294.73;
29.11.2022;29.11.2022;" Tusidedescurunt / Sta.-An. 7833708425 Syllium Sertant VI ";;299.00;107'195.73;
29.11.2022;29.11.2022;" Tusidedescurunt / Sta.-An. 7032268010 Syllium Sertant VI ";;819.00;106'896.73;
29.11.2022;29.11.2022;" Tusidedescurunt / Sta.-An. 2067605722 Syllium Sertant VI ";;489.00;106'077.73;
29.11.2022;29.11.2022;" Tusidedescurunt / Sta.-An. 8480872185 Syllium Sertant VI ";;420.00;105'588.73;
29.11.2022;29.11.2022;" Tusidedescurunt / Sta.-An. 3043517048 Syllium Sertant VI ";;349.00;105'168.73;
29.11.2022;29.11.2022;" Tusidedescurunt / Sta.-An. 6826313606 Syllium Sertant VI ";;70.00;104'819.73;
29.11.2022;29.11.2022;" Tusidedescurunt / Sta.-An. 7053441435 Syllium Sertant VI ";;74.91;104'749.73;
29.11.2022;29.11.2022;" Tusidedescurunt / Sta.-An. 4522084032 Syllium Sertant VI ";;289.00;104'674.82;
29.11.2022;29.11.2022;" Tusidedescurunt / Sta.-An. 5674102347 Syllium Sertant VI ";;499.00;104'385.82;
29.11.2022;29.11.2022;" Tusidedescurunt / Sta.-An. 2882606834 Syllium Sertant VI ";;35.00;103'886.82;
29.11.2022;29.11.2022;" Tusidedescurunt / Sta.-An. 3831356068 Syllium Sertant VI ";;100.00;103'851.82;
29.11.2022;29.11.2022;" Tusidedescurunt / Sta.-An. 6060681461 Syllium Sertant VI ";;35.00;103'751.82;
29.11.2022;29.11.2022;" Tusidedescurunt / Sta.-An. 7864088344 Syllium Sertant VI ";;119.90;103'716.82;
29.11.2022;29.11.2022;" Tusidedescurunt / Sta.-An. 7540628040 Syllium Sertant VI ";;309.00;103'596.92;
29.11.2022;29.11.2022;" Tusidedescurunt / Sta.-An. 5372066562 Syllium Sertant VI ";;59.00;103'287.92;
29.11.2022;29.11.2022;" Tusidedescurunt / Sta.-An. 6345535278 Syllium Sertant VI ";;54.89;103'228.92;
29.11.2022;29.11.2022;" Tusidedescurunt / Sta.-An. 4503300817 Syllium Sertant VI ";;29.00;103'174.03;
29.11.2022;29.11.2022;" Tusidedescurunt / Sta.-An. 6801534346 Syllium Sertant VI ";;99.00;103'145.03;
29.11.2022;29.11.2022;" Tusidedescurunt / Sta.-An. 3245775606 Syllium Sertant VI ";;99.00;103'046.03;
29.11.2022;29.11.2022;" Tusidedescurunt / Sta.-An. 5244044468 Syllium Sertant VI ";;79.00;102'947.03;
29.11.2022;29.11.2022;" Tusidedescurunt / Sta.-An. 1453663775 Syllium Sertant VI ";;35.00;102'868.03;
29.11.2022;29.11.2022;" Tusidedescurunt / Sta.-An. 2131233104 Syllium Sertant VI ";;35.00;102'833.03;
29.11.2022;29.11.2022;" Tusidedescurunt / Sta.-An. 3476482471 Syllium Sertant VI ";;359.00;102'798.03;
29.11.2022;29.11.2022;" Tusidedescurunt / Sta.-An. 4084245314 Syllium Sertant VI ";;729.00;102'439.03;
29.11.2022;29.11.2022;" Tusidedescurunt / Sta.-An. 2222211387 Syllium Sertant VI ";;35.00;101'710.03;
29.11.2022;29.11.2022;" Tusidedescurunt / Sta.-An. 4851432473 Syllium Sertant VI ";;589.00;101'675.03;
29.11.2022;29.11.2022;" Tusidedescurunt / Sta.-An. 1875444067 BONUM Secriduor VI ";;253.37;101'086.03;
29.11.2022;29.11.2022;" Tusidedescurunt / Sta.-An. 6737014356 Syllium Sertant VI ";;99.00;100'832.66;
29.11.2022;29.11.2022;" Tusidedescurunt / Sta.-An. 1624254653 Syllium Sertant VI ";;127.00;100'733.66;
29.11.2022;29.11.2022;" Tusidedescurunt / Sta.-An. 1785480825 Syllium Sertant VI ";;99.00;100'606.66;
29.11.2022;29.11.2022;" Crememperituunt v-chorope (Comisu Tirumende: 2 / Sta.-An. 8572327051) ";1'706.77;;100'507.66;
29.11.2022;29.11.2022;" Crememperituunt v-chorope (Comisu Tirumende: 4 / Sta.-An. 6768756132) ";642.33;;102'214.43;
29.11.2022;29.11.2022;" Tusidedescurunt / Sta.-An. 2061128771 Syllium Sertant VI ";;99.00;102'856.76;
29.11.2022;29.11.2022;" Tusidedescurunt / Sta.-An. 7564244723 Syllium Sertant VI ";;35.00;102'757.76;
29.11.2022;29.11.2022;" Tusidedescurunt / Sta.-An. 4635812820 Syllium Sertant VI ";;99.00;102'722.76;
29.11.2022;29.11.2022;" Tusidedescurunt / Sta.-An. 5251028604 Syllium Sertant VI ";;119.80;102'623.76;
29.11.2022;29.11.2022;" Tusidedescurunt / Sta.-An. 6244337523 Syllium Sertant VI ";;209.00;102'503.96;
29.11.2022;29.11.2022;" Tusidedescurunt / Sta.-An. 1588285735 Syllium Sertant VI ";;35.00;102'294.96;
29.11.2022;29.11.2022;" Tusidedescurunt / Sta.-An. 5316335160 Syllium Sertant VI ";;49.00;102'259.96;
29.11.2022;29.11.2022;" Tusidedescurunt / Sta.-An. 3234600543 Syllium Sertant VI ";;259.00;102'210.96;
29.11.2022;29.11.2022;" Tusidedescurunt / Sta.-An. 8544861440 Syllium Sertant VI ";;39.90;101'951.96;
29.11.2022;29.11.2022;" Tusidedescurunt / Sta.-An. 8515735505 Syllium Sertant VI ";;79.00;101'912.06;
29.11.2022;29.11.2022;" Tusidedescurunt / Sta.-An. 5044523744 BONUM Secriduor VI ";;1'955.14;101'833.06;
29.11.2022;29.11.2022;" Tusidedescurunt / Sta.-An. 2520778704 BONUM Secriduor VI ";;1'750.83;99'877.92;
29.11.2022;26.11.2022;Orunarenti sus Morabibruntrarat MINVES *EMI6321070112 327-565-4814;1'000.00;;98'127.09;
29.11.2022;29.11.2022;" Tusidedescurunt / Sta.-An. 6124016582 DECTUENEM CULCEAT VI ";;111.56;99'127.09;
29.11.2022;29.11.2022;" Tusidedescurunt / Sta.-An. 2856650810 DECTUENEM CULCEAT VI ";;594.96;99'015.53;
29.11.2022;29.11.2022;" Tusidedescurunt / Sta.-An. 3428336180 DECTUENEM CULCEAT VI ";;765.72;98'420.57;
29.11.2022;29.11.2022;" Peramente v-chorope / Sta.-An. 1628273383 MALEST ALIDUM POSTRAGO ";6'728.15;;97'654.85;
29.11.2022;29.11.2022;" Peramente v-chorope / Sta.-An. 5038731235 XXX STRIBI ";1'206.74;;104'383.00;
29.11.2022;29.11.2022;" Peramente v-chorope / Sta.-An. 4368555455 BIES INO ";4'229.80;;105'589.74;
28.11.2022;28.11.2022;" Tusidedescurunt / Sta.-An. 1567208516 Syllium Sertant VI ";;35.00;109'819.54;
28.11.2022;28.11.2022;" Tusidedescurunt / Sta.-An. 6742832805 Syllium Sertant VI ";;209.00;109'784.54;
28.11.2022;28.11.2022;" Tusidedescurunt / Sta.-An. 2604671077 Syllium Sertant VI ";;54.89;109'575.54;
28.11.2022;28.11.2022;" Tusidedescurunt / Sta.-An. 3080863012 Syllium Sertant VI ";;49.00;109'520.65;
28.11.2022;28.11.2022;" Tusidedescurunt / Sta.-An. 8353383573 Syllium Sertant VI ";;35.00;109'471.65;
28.11.2022;28.11.2022;" Tusidedescurunt / Sta.-An. 8860160785 Syllium Sertant VI ";;35.00;109'436.65;
28.11.2022;28.11.2022;" Tusidedescurunt / Sta.-An. 4515421318 VoloNerigem VI ";;97.71;109'401.65;
28.11.2022;28.11.2022;" Tusidedescurunt / Sta.-An. 7240433440 BONUM Secriduor VI ";;27.54;109'303.94;
28.11.2022;28.11.2022;" Peramente v-chorope / Sta.-An. 8711856851 CAURRE INO ";1'680.20;;109'276.40;
28.11.2022;28.11.2022;" Tusidedescurunt / Sta.-An. 7203857045 DECTUENEM CULCEAT VI ";;1'223.25;110'956.60;
28.11.2022;28.11.2022;" Tusidedescurunt / Sta.-An. 1571177727 DECTUENEM CULCEAT VI ";;597.85;109'733.35;
28.11.2022;28.11.2022;" Tusidedescurunt / Sta.-An. 8142758774 Sensisu-Vens Veguli sus/ocus Numnis ";;837.00;109'135.50;
28.11.2022;28.11.2022;" Peramente v-chorope / Sta.-An. 6684444615 LUDUM EXPERURELIS + MOLETE VI ";145.50;;108'298.50;
28.11.2022;28.11.2022;" Peramente v-chorope / Sta.-An. 7208614501 ";694.75;;108'444.00;
28.11.2022;24.11.2022;Orunarenti sus Morabibruntrarat Menti-4117 Pier Pier;5.95;;109'138.75;
25.11.2022;25.11.2022;" Tusidedescurunt / Sta.-An. 6702568857 Syllium Sertant VI ";;35.00;109'144.70;
25.11.2022;25.11.2022;" Tusidedescurunt / Sta.-An. 4254785180 Syllium Sertant VI ";;35.00;109'109.70;
25.11.2022;25.11.2022;" Tusidedescurunt / Sta.-An. 3151637587 Syllium Sertant VI ";;39.00;109'074.70;
25.11.2022;25.11.2022;" Tusidedescurunt / Sta.-An. 4243346116 Syllium Sertant VI ";;109.00;109'035.70;
25.11.2022;25.11.2022;" Tusidedescurunt / Sta.-An. 7755372685 Syllium Sertant VI ";;609.00;108'926.70;
25.11.2022;25.11.2022;" Tusidedescurunt / Sta.-An. 4767188327 Syllium Sertant VI ";;44.90;108'317.70;
25.11.2022;25.11.2022;" Tusidedescurunt / Sta.-An. 3567704781 Syllium Sertant VI ";;35.00;108'272.80;
25.11.2022;25.11.2022;" Tusidedescurunt / Sta.-An. 1758678663 Syllium Sertant VI ";;99.00;108'237.80;
25.11.2022;25.11.2022;" Tusidedescurunt / Sta.-An. 7002473458 Syllium Sertant VI ";;99.00;108'138.80;
25.11.2022;25.11.2022;" Tusidedescurunt / Sta.-An. 5256068575 Syllium Sertant VI ";;145.00;108'039.80;
25.11.2022;25.11.2022;" Tusidedescurunt / Sta.-An. 8658431767 VoloNerigem VI ";;196.41;107'894.80;
25.11.2022;25.11.2022;" Tusidedescurunt / Sta.-An. 5846105747 BONUM Secriduor VI ";;278.14;107'698.39;
25.11.2022;25.11.2022;" Tusidedescurunt / Sta.-An. 7602380470 Ferbis Nolverbit ";;189.00;107'420.25;
25.11.2022;25.11.2022;" Tusidedescurunt / Sta.-An. 6165878513 DECTUENEM CULCEAT VI ";;1'826.17;107'231.25;
25.11.2022;25.11.2022;" Tusidedescurunt / Sta.-An. 4361137080 DECTUENEM CULCEAT VI ";;1'318.50;105'405.08;
25.11.2022;23.11.2022;Orunarenti sus Morabibruntrarat EXIMere Viritium 46565 Viritium;19.00;;104'086.58;
25.11.2022;23.11.2022;Orunarenti sus Morabibruntrarat Periple IN Tatusta Disquaesex;93.75;;104'105.58;
25.11.2022;25.11.2022;" Peramente v-chorope / Sta.-An. 5564036118 VIRUNT PARGET ADRABITI SEGI ";1'380.00;;104'199.33;
25.11.2022;25.11.2022;" Tusidedescurunt / Sta.-An. 8402667800 Fore Reris Conse ";;49.00;105'579.33;
25.11.2022;25.11.2022;" Tusidedescurunt / Sta.-An. 8284831057 Atudo Ferum SegI ";;1'388.50;105'530.33;
24.11.2022;24.11.2022;" Tusidedescurunt / Sta.-An. 7528688537 VoloNerigem VI ";;38.49;104'141.83;
24.11.2022;24.11.2022;" Tusidedescurunt / Sta.-An. 8771138655 TERIENDIERVA AT ";;7'475.84;104'103.34;
24.11.2022;22.11.2022;Orunarenti sus Morabibruntrarat Menti-4117 Pier Pier;9.95;;96'627.50;
24.11.2022;24.11.2022;" Tusidedescurunt / Sta.-An. 7120314525 BONUM Secriduor VI ";;165.43;96'637.45;
24.11.2022;24.11.2022;" Tusidedescurunt / Sta.-An. 5241226160 DECTUENEM CULCEAT VI ";;590.31;96'472.02;
24.11.2022;24.11.2022;" Peramente v-chorope / Sta.-An. 7532136727 V. AMILIA HIUNT F/B ";2'491.63;;95'881.71;
24.11.2022;24.11.2022;" Tusidedescurunt / Sta.-An. 3085565208 Inta Mortianga ";;29.00;98'373.34;
23.11.2022;23.11.2022;" Tusidedescurunt / Sta.-An. 1763142348 CARAER QUE DIT ";;2'584.18;98'344.34;
23.11.2022;23.11.2022;" Tusidedescurunt / Sta.-An. 6337378247 Syllium Sertant VI ";;29.00;95'760.16;
23.11.2022;23.11.2022;" Tusidedescurunt / Sta.-An. 7206424080 Syllium Sertant VI ";;209.00;95'731.16;
23.11.2022;23.11.2022;" Tusidedescurunt / Sta.-An. 4277183365 Syllium Sertant VI ";;45.00;95'522.16;
23.11.2022;23.11.2022;" Tusidedescurunt / Sta.-An. 6170722400 Syllium Sertant VI ";;209.00;95'477.16;
23.11.2022;23.11.2022;" Tusidedescurunt / Sta.-An. 7721738224 Syllium Sertant VI ";;35.00;95'268.16;
23.11.2022;23.11.2022;" Tusidedescurunt / Sta.-An. 4857806856 Syllium Sertant VI ";;99.00;95'233.16;
23.11.2022;23.11.2022;" Tusidedescurunt / Sta.-An. 3680574221 Syllium Sertant VI ";;119.00;95'134.16;
23.11.2022;23.11.2022;" Tusidedescurunt / Sta.-An. 1070563260 Syllium Sertant VI ";;99.00;95'015.16;
23.11.2022;23.11.2022;" Tusidedescurunt / Sta.-An. 6601106758 Syllium Sertant VI ";;669.00;94'916.16;
23.11.2022;23.11.2022;" Tusidedescurunt / Sta.-An. 3253004771 Syllium Sertant VI ";;309.00;94'247.16;
23.11.2022;23.11.2022;" Tusidedescurunt / Sta.-An. 1725252537 Syllium Sertant VI ";;99.00;93'938.16;
23.11.2022;23.11.2022;" Tusidedescurunt / Sta.-An. 7478246548 Syllium Sertant VI ";;79.90;93'839.16;
23.11.2022;23.11.2022;" Tusidedescurunt / Sta.-An. 4216886130 Syllium Sertant VI ";;105.00;93'759.26;
23.11.2022;23.11.2022;" Tusidedescurunt / Sta.-An. 5673803433 Syllium Sertant VI ";;195.00;93'654.26;
23.11.2022;23.11.2022;" Tusidedescurunt / Sta.-An. 2380150500 BONUM Secriduor VI ";;209.14;93'459.26;
23.11.2022;23.11.2022;" Tusidedescurunt / Sta.-An. 4586781533 DECTUENEM CULCEAT VI ";;161.01;93'250.12;
23.11.2022;23.11.2022;" Peramente v-chorope / Sta.-An. 7051114540 PIRATE VI ";4'338.00;;93'089.11;
22.11.2022;22.11.2022;" Tusidedescurunt / Sta.-An. 3232651051 BONUM Secriduor VI ";;785.65;97'427.11;
22.11.2022;22.11.2022;" Tusidedescurunt / Sta.-An. 1688750331 Syllium Sertant VI ";;35.00;96'641.46;
22.11.2022;22.11.2022;" Tusidedescurunt / Sta.-An. 3624684123 Syllium Sertant VI ";;349.00;96'606.46;
22.11.2022;22.11.2022;" Tusidedescurunt / Sta.-An. 4506536821 Syllium Sertant VI ";;195.00;96'257.46;
22.11.2022;22.11.2022;" Tusidedescurunt / Sta.-An. 1868702616 Syllium Sertant VI ";;99.00;96'062.46;
22.11.2022;22.11.2022;" Tusidedescurunt / Sta.-An. 3045224316 Syllium Sertant VI ";;35.00;95'963.46;
22.11.2022;22.11.2022;" Tusidedescurunt / Sta.-An. 6451465351 Syllium Sertant VI ";;35.00;95'928.46;
22.11.2022;22.11.2022;" Tusidedescurunt / Sta.-An. 5668781443 Syllium Sertant VI ";;169.90;95'893.46;
22.11.2022;22.11.2022;" Tusidedescurunt / Sta.-An. 6243427352 Syllium Sertant VI ";;110.00;95'723.56;
22.11.2022;22.11.2022;" Tusidedescurunt / Sta.-An. 6488575650 Syllium Sertant VI ";;519.00;95'613.56;
22.11.2022;22.11.2022;" Tusidedescurunt / Sta.-An. 2131758030 BONUM Secriduor VI ";;242.50;95'094.56;
22.11.2022;18.11.2022;Orunarenti sus Morabibruntrarat MINVES*EMI6321070112 DOLINTUM;1'000.00;;94'852.06;
22.11.2022;20.11.2022;Orunarenti sus Morabibruntrarat MINVES*EMI6321070112 DOLINTUM;1'000.00;;95'852.06;
22.11.2022;20.11.2022;Orunarenti sus Morabibruntrarat Pede VI Viäcossus Viäcossus;104.35;;96'852.06;
22.11.2022;22.11.2022;" Tusidedescurunt / Sta.-An. 6676442505 BONUM Secriduor VI ";;165.60;96'956.41;
22.11.2022;22.11.2022;" Tusidedescurunt / Sta.-An. 5520334074 DECTUENEM CULCEAT VI ";;4'709.45;96'790.81;
22.11.2022;22.11.2022;Expettribentemüin Nomneri Fluva ********1136 37.54.4118 - 15.54.4118;3.00;;92'081.36;
22.11.2022;22.11.2022;" Tusidedescurunt / Sta.-An. 8667264875 DECTUENEM CULCEAT VI ";;62.74;92'084.36;
22.11.2022;22.11.2022;" Peramente v-chorope / Sta.-An. 2473643388 ALIUM MOLETE SEGI ";1'664.27;;92'021.62;
21.11.2022;21.11.2022;" Tusidedescurunt / Sta.-An. 7248377488 Syllium Sertant VI ";;49.00;93'685.89;
21.11.2022;21.11.2022;" Tusidedescurunt / Sta.-An. 6184002737 Syllium Sertant VI ";;409.00;93'636.89;
21.11.2022;21.11.2022;" Tusidedescurunt / Sta.-An. 1220171122 Syllium Sertant VI ";;105.00;93'227.89;
21.11.2022;21.11.2022;" Tusidedescurunt / Sta.-An. 3272201713 Syllium Sertant VI ";;539.00;93'122.89;
21.11.2022;21.11.2022;" Tusidedescurunt / Sta.-An. 2526111465 Syllium Sertant VI ";;89.00;92'583.89;
21.11.2022;21.11.2022;" Tusidedescurunt / Sta.-An. 2550886380 Syllium Sertant VI ";;49.00;92'494.89;
21.11.2022;21.11.2022;" Tusidedescurunt / Sta.-An. 7406225758 Syllium Sertant VI ";;39.00;92'445.89;
21.11.2022;21.11.2022;" Tusidedescurunt / Sta.-An. 8054234007 Syllium Sertant VI ";;189.00;92'406.89;
21.11.2022;21.11.2022;" Tusidedescurunt / Sta.-An. 1401066538 Syllium Sertant VI ";;79.00;92'217.89;
21.11.2022;21.11.2022;" Tusidedescurunt / Sta.-An. 4867516625 Syllium Sertant VI ";;39.00;92'138.89;
21.11.2022;21.11.2022;" Tusidedescurunt / Sta.-An. 6185725875 Syllium Sertant VI ";;1'009.00;92'099.89;
21.11.2022;21.11.2022;" Tusidedescurunt / Sta.-An. 8412023274 VoloNerigem VI ";;88.73;91'090.89;
21.11.2022;21.11.2022;" Tusidedescurunt / Sta.-An. 7234513343 BONUM Secriduor VI ";;162.46;91'002.16;
21.11.2022;21.11.2022;" Tusidedescurunt / Sta.-An. 1446028124 TERIENDIERVA AT ";;3'340.78;90'839.70;
21.11.2022;21.11.2022;" Tusidedescurunt / Sta.-An. 8287815860 DECTUENEM CULCEAT VI ";;2'755.88;87'498.92;
21.11.2022;21.11.2022;" Tusidedescurunt / Sta.-An. 8817486530 DECTUENEM CULCEAT VI ";;490.06;84'743.04;
21.11.2022;21.11.2022;" Tusidedescurunt / Sta.-An. 3842253788 SUBSITE SegI-Mago sex Funtubi ";;229.55;84'252.98;
21.11.2022;21.11.2022;" Tusidedescurunt / Sta.-An. 4087327500 AMITANA DECREPRO ";;2'708.00;84'023.43;
21.11.2022;21.11.2022;" Tusidedescurunt / Sta.-An. 3246413124 Luvidest Flate ";;199.00;81'315.43;
21.11.2022;21.11.2022;" Crememperituunt v-chorope (Comisu Tirumende: 4 / Sta.-An. 8801385216) ";3'436.50;;81'116.43;
21.11.2022;21.11.2022;" Crememperituunt v-chorope (Comisu Tirumende: 4 / Sta.-An. 3641144845) ";2'244.35;;84'552.93;
21.11.2022;21.11.2022;" Tusidedescurunt / Sta.-An. 4383223062 VoloNerigem VI ";;1'499.77;86'797.28;
21.11.2022;20.11.2022;Expernem-Conumendit 57861304 - RIT Pier;;4'800.00;85'297.51;
21.11.2022;17.11.2022;Orunarenti sus Morabibruntrarat Morata'k Vide Insi Mitia;23.05;;80'497.51;
18.11.2022;18.11.2022;" Tusidedescurunt / Sta.-An. 7802318201 Syllium Sertant VI ";;169.00;80'520.56;
18.11.2022;18.11.2022;" Tusidedescurunt / Sta.-An. 8010145168 Syllium Sertant VI ";;469.00;80'351.56;
18.11.2022;18.11.2022;" Tusidedescurunt / Sta.-An. 2310151752 Syllium Sertant VI ";;129.00;79'882.56;
18.11.2022;18.11.2022;" Tusidedescurunt / Sta.-An. 1528546382 Syllium Sertant VI ";;89.00;79'753.56;
18.11.2022;18.11.2022;" Tusidedescurunt / Sta.-An. 6373134477 Syllium Sertant VI ";;249.00;79'664.56;
18.11.2022;18.11.2022;" Tusidedescurunt / Sta.-An. 4620632672 Syllium Sertant VI ";;559.00;79'415.56;
18.11.2022;18.11.2022;" Tusidedescurunt / Sta.-An. 1068414450 Syllium Sertant VI ";;69.90;78'856.56;
18.11.2022;18.11.2022;" Tusidedescurunt / Sta.-An. 8536156032 Syllium Sertant VI ";;99.00;78'786.66;
18.11.2022;18.11.2022;" Tusidedescurunt / Sta.-An. 4683486608 Syllium Sertant VI ";;638.99;78'687.66;
18.11.2022;18.11.2022;" Tusidedescurunt / Sta.-An. 4057046002 Syllium Sertant VI ";;29.90;78'048.67;
18.11.2022;18.11.2022;" Tusidedescurunt / Sta.-An. 2787514344 Syllium Sertant VI ";;109.00;78'018.77;
18.11.2022;18.11.2022;" Tusidedescurunt / Sta.-An. 7820323006 Syllium Sertant VI ";;99.00;77'909.77;
18.11.2022;18.11.2022;" Tusidedescurunt / Sta.-An. 4121510661 Syllium Sertant VI ";;35.00;77'810.77;
18.11.2022;18.11.2022;" Tusidedescurunt / Sta.-An. 6678336103 Syllium Sertant VI ";;719.01;77'775.77;
18.11.2022;18.11.2022;" Tusidedescurunt / Sta.-An. 1763160613 Syllium Sertant VI ";;419.00;77'056.76;
18.11.2022;18.11.2022;Expernem-Conumendit 53350133 - RIT Putum, REM;;1'120.00;76'637.76;
18.11.2022;18.11.2022;" Tusidedescurunt / Sta.-An. 5381287346 BONUM Secriduor VI ";;415.22;75'517.76;
18.11.2022;16.11.2022;Orunarenti sus Morabibruntrarat MINVES*EMI6321070112 DOLINTUM;1'000.00;;75'102.54;
18.11.2022;16.11.2022;Orunarenti sus Morabibruntrarat Miuvimor Molvel NEINI VI;65.00;;76'102.54;
18.11.2022;18.11.2022;" Crememperituunt v-chorope (Comisu Tirumende: 1 / Sta.-An. 7676651200) ";2'815.25;;76'167.54;
18.11.2022;18.11.2022;" Crememperituunt v-chorope (Comisu Tirumende: 4 / Sta.-An. 7735183843) ";19'438.64;;78'982.79;
18.11.2022;18.11.2022;" Tusidedescurunt / Sta.-An. 4866530478 DECTUENEM CULCEAT VI ";;655.06;98'421.43;
18.11.2022;18.11.2022;" Tusidedescurunt / Sta.-An. 4708074654 DECTUENEM CULCEAT VI ";;84.17;97'766.37;
18.11.2022;18.11.2022;" Tusidedescurunt / Sta.-An. 4566266165 Rintabit. Habile Ster ";;358.00;97'682.20;
17.11.2022;17.11.2022;" Secelegitiatuiem (Comisu Tirumende: 7 / Sta.-An. 6772332643) ";;49.00;97'324.20;
17.11.2022;17.11.2022;" Peramente v-chorope / Sta.-An. 5638824320 IDE OS FRUNT ";448.78;;97'275.20;
17.11.2022;17.11.2022;" Tusidedescurunt / Sta.-An. 7502672325 BONUM Secriduor VI ";;24.58;97'723.98;
17.11.2022;17.11.2022;" Tusidedescurunt / Sta.-An. 6101062626 PUGAUSTA CARGEM ";;89.00;97'699.40;
17.11.2022;17.11.2022;" Tusidedescurunt / Sta.-An. 6055178821 CONSUSTA STOGINCH DOMELIA ";;708.00;97'610.40;
17.11.2022;17.11.2022;" Crememperituunt v-chorope (Comisu Tirumende: 5 / Sta.-An. 4381806188) ";2'555.68;;96'902.40;
17.11.2022;17.11.2022;" Tusidedescurunt / Sta.-An. 5070706011 DECTUENEM CULCEAT VI ";;739.27;99'458.08;
17.11.2022;17.11.2022;" Tusidedescurunt / Sta.-An. 8607634435 DECTUENEM CULCEAT VI ";;436.00;98'718.81;
17.11.2022;17.11.2022;" Peramente v-chorope / Sta.-An. 4441836453 V. AMILIA HIUNT F/B ";2'496.75;;98'282.81;
16.11.2022;16.11.2022;" Tusidedescurunt / Sta.-An. 5386076756 Syllium Sertant VI ";;58.00;100'779.56;
16.11.2022;16.11.2022;" Tusidedescurunt / Sta.-An. 4802460340 Syllium Sertant VI ";;140.00;100'721.56;
16.11.2022;16.11.2022;" Tusidedescurunt / Sta.-An. 8214418688 Syllium Sertant VI ";;179.00;100'581.56;
16.11.2022;16.11.2022;" Tusidedescurunt / Sta.-An. 1866065770 Syllium Sertant VI ";;309.00;100'402.56;
16.11.2022;16.11.2022;" Tusidedescurunt / Sta.-An. 4425118270 Syllium Sertant VI ";;99.00;100'093.56;
16.11.2022;16.11.2022;" Tusidedescurunt / Sta.-An. 8170237086 Syllium Sertant VI ";;198.00;99'994.56;
16.11.2022;16.11.2022;" Tusidedescurunt / Sta.-An. 8674672043 Syllium Sertant VI ";;99.00;99'796.56;
16.11.2022;16.11.2022;" Tusidedescurunt / Sta.-An. 3336641117 Syllium Sertant VI ";;179.00;99'697.56;
16.11.2022;16.11.2022;" Tusidedescurunt / Sta.-An. 5652025887 Syllium Sertant VI ";;180.00;99'518.56;
16.11.2022;16.11.2022;" Tusidedescurunt / Sta.-An. 3875383267 Syllium Sertant VI ";;459.00;99'338.56;
16.11.2022;16.11.2022;" Tusidedescurunt / Sta.-An. 2025613065 Syllium Sertant VI ";;109.00;98'879.56;
16.11.2022;16.11.2022;" Tusidedescurunt / Sta.-An. 2503167274 VoloNerigem VI ";;211.22;98'770.56;
16.11.2022;16.11.2022;" Tusidedescurunt / Sta.-An. 4628504855 VoloNerigem VI ";;104.54;98'559.34;
16.11.2022;16.11.2022;" Peramente v-chorope / Sta.-An. 3783352037 CEPE LEGINUS VI ";86.45;;98'454.80;
16.11.2022;14.11.2022;Orunarenti sus Morabibruntrarat MINVES *EMI6321070112 327-565-4814;1'000.00;;98'541.25;
16.11.2022;16.11.2022;" Tusidedescurunt / Sta.-An. 2210764271 BONUM Secriduor VI ";;3'006.22;99'541.25;
16.11.2022;16.11.2022;" Tusidedescurunt / Sta.-An. 4070013508 DECTUENEM CULCEAT VI ";;9'869.93;96'535.03;
16.11.2022;16.11.2022;" Tusidedescurunt / Sta.-An. 4585432056 DECTUENEM CULCEAT VI ";;43.18;86'665.10;
16.11.2022;16.11.2022;" Tusidedescurunt / Sta.-An. 4052666664 Franto. Nolorte ";;2'100.00;86'621.92;
16.11.2022;16.11.2022;" Peramente v-chorope / Sta.-An. 6346302331 REPARE HYACIDERI ";4'743.14;;84'521.92;
16.11.2022;16.11.2022;" Peramente v-chorope / Sta.-An. 5718278708 VITA OBANUTUNT F/B ";643.11;;89'265.06;
15.11.2022;15.11.2022;" Secelegitiatuiem (Comisu Tirumende: 7 / Sta.-An. 7525410388) ";;140.00;89'908.17;
15.11.2022;15.11.2022;" Tusidedescurunt / Sta.-An. 4722861675 Syllium Sertant VI ";;134.00;89'768.17;
15.11.2022;15.11.2022;" Tusidedescurunt / Sta.-An. 1542014201 Syllium Sertant VI ";;35.00;89'634.17;
15.11.2022;15.11.2022;" Tusidedescurunt / Sta.-An. 8581828025 Syllium Sertant VI ";;35.00;89'599.17;
15.11.2022;15.11.2022;" Tusidedescurunt / Sta.-An. 4825723078 Syllium Sertant VI ";;129.00;89'564.17;
15.11.2022;15.11.2022;" Tusidedescurunt / Sta.-An. 8515554532 Syllium Sertant VI ";;98.00;89'435.17;
15.11.2022;15.11.2022;" Tusidedescurunt / Sta.-An. 3023825573 Syllium Sertant VI ";;95.00;89'337.17;
15.11.2022;15.11.2022;" Tusidedescurunt / Sta.-An. 6624072423 Syllium Sertant VI ";;129.00;89'242.17;
15.11.2022;15.11.2022;" Tusidedescurunt / Sta.-An. 3230507718 Syllium Sertant VI ";;359.00;89'113.17;
15.11.2022;15.11.2022;" Tusidedescurunt / Sta.-An. 1446065552 VoloNerigem VI ";;2'054.77;88'754.17;
15.11.2022;15.11.2022;" Tusidedescurunt / Sta.-An. 7343301644 TERIENDIERVA AT ";;5'325.82;86'699.40;
15.11.2022;15.11.2022;" Tusidedescurunt / Sta.-An. 2601186131 BONUM Secriduor VI ";;171.74;81'373.58;
15.11.2022;15.11.2022;" Tusidedescurunt / Sta.-An. 8242562385 BONUM Secriduor VI ";;88.44;81'201.84;
15.11.2022;11.11.2022;Orunarenti sus Morabibruntrarat MINVES *EMI6321070112 327-565-4814;1'000.00;;81'113.40;
15.11.2022;13.11.2022;Orunarenti sus Morabibruntrarat MINVES *EMI6321070112 327-565-4814;1'000.00;;82'113.40;
15.11.2022;15.11.2022;" Tusidedescurunt / Sta.-An. 1300462434 BONUM Secriduor VI ";;734.23;83'113.40;
15.11.2022;15.11.2022;" Tusidedescurunt / Sta.-An. 7266783088 DECTUENEM CULCEAT VI ";;1'880.34;82'379.17;
15.11.2022;15.11.2022;" Tusidedescurunt / Sta.-An. 8282001765 DECTUENEM CULCEAT VI ";;435.45;80'498.83;
15.11.2022;15.11.2022;" Tusidedescurunt / Sta.-An. 3574748280 DECTUENEM CULCEAT VI ";;111.77;80'063.38;
15.11.2022;15.11.2022;" Tusidedescurunt / Sta.-An. 7656187760 DECTUENEM CULCEAT VI ";;1'763.26;79'951.61;
15.11.2022;15.11.2022;" Peramente v-chorope / Sta.-An. 8888804658 COGIT COLEG SEGI ";6'688.87;;78'188.35;
15.11.2022;15.11.2022;" Peramente v-chorope / Sta.-An. 6387154806 IMULUCENDUSTERE ORTABELINTINUTUS ";4'425.00;;84'877.22;
15.11.2022;15.11.2022;" Peramente v-chorope / Sta.-An. 7627277716 SOLO PLAM SEGI ";203.25;;89'302.22;
15.11.2022;15.11.2022;" Peramente v-chorope / Sta.-An. 4780505860 BONTUUNIS STRATU TENSULIA ";855.36;;89'505.47;
14.11.2022;14.11.2022;" Tusidedescurunt / Sta.-An. 4570165671 Syllium Sertant VI ";;158.00;90'360.83;
14.11.2022;14.11.2022;" Tusidedescurunt / Sta.-An. 6147783781 Syllium Sertant VI ";;119.00;90'202.83;
14.11.2022;14.11.2022;" Tusidedescurunt / Sta.-An. 8288631135 Syllium Sertant VI ";;129.00;90'083.83;
14.11.2022;14.11.2022;" Tusidedescurunt / Sta.-An. 7601810486 Syllium Sertant VI ";;39.00;89'954.83;
14.11.2022;14.11.2022;" Tusidedescurunt / Sta.-An. 2063755580 Syllium Sertant VI ";;99.00;89'915.83;
14.11.2022;14.11.2022;" Tusidedescurunt / Sta.-An. 8162462788 Syllium Sertant VI ";;99.00;89'816.83;
14.11.2022;14.11.2022;" Tusidedescurunt / Sta.-An. 6214582780 Syllium Sertant VI ";;219.00;89'717.83;
14.11.2022;14.11.2022;" Tusidedescurunt / Sta.-An. 2604511663 Syllium Sertant VI ";;938.00;89'498.83;
14.11.2022;14.11.2022;" Tusidedescurunt / Sta.-An. 2755602482 BONUM Secriduor VI ";;364.20;88'560.83;
14.11.2022;14.11.2022;" Crememperituunt v-chorope (Comisu Tirumende: 4 / Sta.-An. 2627111853) ";2'201.28;;88'196.63;
14.11.2022;14.11.2022;" Crememperituunt v-chorope (Comisu Tirumende: 3 / Sta.-An. 3440613601) ";8'586.05;;90'397.91;
14.11.2022;14.11.2022;" Peramente v-chorope / Sta.-An. 7852085186 VENTERE PULO VI ";4'150.00;;98'983.96;
14.11.2022;14.11.2022;" Tusidedescurunt / Sta.-An. 2554452562 Dedduobar VETE SegI ";;5'012.63;103'133.96;
14.11.2022;14.11.2022;" Tusidedescurunt / Sta.-An. 7615331171 Siget Putudas ocus Sentem ";;1'248.00;98'121.33;
14.11.2022;14.11.2022;" Tusidedescurunt / Sta.-An. 7518825533 Statulo Hororte ";;3'600.00;96'873.33;
14.11.2022;14.11.2022;" Tusidedescurunt / Sta.-An. 2865715143 Nanas Plapor ";;779.00;93'273.33;
14.11.2022;14.11.2022;" Tusidedescurunt / Sta.-An. 8778601644 VoloNerigem VI ";;199.77;92'494.33;
14.11.2022;10.11.2022;Orunarenti sus Morabibruntrarat AELLUCENDIE ARE LETRIANUM;86.85;;92'294.56;
11.11.2022;11.11.2022;" Tusidedescurunt / Sta.-An. 5750801766 Syllium Sertant VI ";;239.00;92'381.41;
11.11.2022;11.11.2022;" Tusidedescurunt / Sta.-An. 7625725012 Syllium Sertant VI ";;129.00;92'142.41;
11.11.2022;11.11.2022;" Tusidedescurunt / Sta.-An. 6125007221 Syllium Sertant VI ";;70.00;92'013.41;
11.11.2022;11.11.2022;" Tusidedescurunt / Sta.-An. 3733824488 Syllium Sertant VI ";;49.00;91'943.41;
11.11.2022;11.11.2022;" Tusidedescurunt / Sta.-An. 3654714863 Syllium Sertant VI ";;929.00;91'894.41;
11.11.2022;11.11.2022;" Tusidedescurunt / Sta.-An. 4423450350 Syllium Sertant VI ";;218.00;90'965.41;
11.11.2022;11.11.2022;" Tusidedescurunt / Sta.-An. 4124252142 Syllium Sertant VI ";;29.00;90'747.41;
11.11.2022;11.11.2022;" Tusidedescurunt / Sta.-An. 5164736574 Syllium Sertant VI ";;89.00;90'718.41;
11.11.2022;11.11.2022;" Tusidedescurunt / Sta.-An. 2231828410 Syllium Sertant VI ";;129.00;90'629.41;
11.11.2022;11.11.2022;" Tusidedescurunt / Sta.-An. 1061070246 Syllium Sertant VI ";;35.00;90'500.41;
11.11.2022;11.11.2022;" Tusidedescurunt / Sta.-An. 7588737274 Syllium Sertant VI ";;179.00;90'465.41;
11.11.2022;11.11.2022;" Tusidedescurunt / Sta.-An. 8668446450 Syllium Sertant VI ";;59.90;90'286.41;
11.11.2022;11.11.2022;" Tusidedescurunt / Sta.-An. 5042851604 Syllium Sertant VI ";;158.00;90'226.51;
11.11.2022;11.11.2022;" Tusidedescurunt / Sta.-An. 4235881273 Syllium Sertant VI ";;34.89;90'068.51;
11.11.2022;11.11.2022;" Tusidedescurunt / Sta.-An. 4487154625 Syllium Sertant VI ";;29.00;90'033.62;
11.11.2022;11.11.2022;" Tusidedescurunt / Sta.-An. 6086288267 Syllium Sertant VI ";;59.90;90'004.62;
11.11.2022;11.11.2022;" Tusidedescurunt / Sta.-An. 1368410012 Syllium Sertant VI ";;29.00;89'944.72;
11.11.2022;11.11.2022;" Tusidedescurunt / Sta.-An. 1414841428 Syllium Sertant VI ";;199.00;89'915.72;
11.11.2022;11.11.2022;" Tusidedescurunt / Sta.-An. 4827708576 Syllium Sertant VI ";;259.00;89'716.72;
11.11.2022;11.11.2022;" Tusidedescurunt / Sta.-An. 2356685507 Syllium Sertant VI ";;35.00;89'457.72;
11.11.2022;11.11.2022;" Tusidedescurunt / Sta.-An. 6737427858 Syllium Sertant VI ";;69.00;89'422.72;
11.11.2022;11.11.2022;" Tusidedescurunt / Sta.-An. 2241247788 Syllium Sertant VI ";;209.00;89'353.72;
11.11.2022;11.11.2022;" Tusidedescurunt / Sta.-An. 2077044506 Syllium Sertant VI ";;29.00;89'144.72;
11.11.2022;11.11.2022;" Tusidedescurunt / Sta.-An. 4680875013 Syllium Sertant VI ";;29.00;89'115.72;
11.11.2022;11.11.2022;" Tusidedescurunt / Sta.-An. 1871244266 Syllium Sertant VI ";;39.00;89'086.72;
11.11.2022;11.11.2022;" Tusidedescurunt / Sta.-An. 8288031168 Syllium Sertant VI ";;198.00;89'047.72;
11.11.2022;11.11.2022;" Tusidedescurunt / Sta.-An. 6633262842 Syllium Sertant VI ";;129.00;88'849.72;
11.11.2022;11.11.2022;" Tusidedescurunt / Sta.-An. 2170157023 Syllium Sertant VI ";;329.00;88'720.72;
11.11.2022;11.11.2022;" Tusidedescurunt / Sta.-An. 7066458286 BONUM Secriduor VI ";;317.82;88'391.72;
11.11.2022;11.11.2022;" Tusidedescurunt / Sta.-An. 2352534061 DECTUENEM CULCEAT VI ";;295.62;88'073.90;
11.11.2022;11.11.2022;" Peramente v-chorope / Sta.-An. 8177878342 HARET FERE VI ";132.75;;87'778.28;
10.11.2022;10.11.2022;" Crememperituunt v-chorope (Comisu Tirumende: 4 / Sta.-An. 3242307384) ";1'593.60;;87'911.03;
10.11.2022;10.11.2022;" Tusidedescurunt / Sta.-An. 5754448621 VoloNerigem VI ";;127.77;89'504.63;
10.11.2022;08.11.2022;Orunarenti sus Morabibruntrarat MINVES *EMI6321070112 327-565-4814;1'000.00;;89'376.86;
10.11.2022;10.11.2022;" Tusidedescurunt / Sta.-An. 7326630772 BONUM Secriduor VI ";;536.43;90'376.86;
10.11.2022;10.11.2022;" Crememperituunt v-chorope (Comisu Tirumende: 51 / Sta.-An. 2437527002) ";6'612.90;;89'840.43;
10.11.2022;10.11.2022;" Crememperituunt v-chorope (Comisu Tirumende: 4 / Sta.-An. 4664564484) ";4'258.31;;96'453.33;
10.11.2022;10.11.2022;" Tusidedescurunt / Sta.-An. 1620871412 DECTUENEM CULCEAT VI ";;4'309.65;100'711.64;
09.11.2022;09.11.2022;" Tusidedescurunt / Sta.-An. 8252424746 Inas Iungunge ";;1'883.00;96'401.99;
09.11.2022;09.11.2022;" Tusidedescurunt / Sta.-An. 1553822401 Syllium Sertant VI ";;69.00;94'518.99;
09.11.2022;09.11.2022;" Tusidedescurunt / Sta.-An. 3735264176 Syllium Sertant VI ";;289.00;94'449.99;
09.11.2022;09.11.2022;" Tusidedescurunt / Sta.-An. 7252666530 Syllium Sertant VI ";;105.00;94'160.99;
09.11.2022;09.11.2022;" Tusidedescurunt / Sta.-An. 1851532044 Syllium Sertant VI ";;469.00;94'055.99;
09.11.2022;09.11.2022;" Tusidedescurunt / Sta.-An. 6664477586 Syllium Sertant VI ";;129.00;93'586.99;
09.11.2022;09.11.2022;" Tusidedescurunt / Sta.-An. 5743084683 Syllium Sertant VI ";;129.00;93'457.99;
09.11.2022;09.11.2022;" Tusidedescurunt / Sta.-An. 5863006380 Syllium Sertant VI ";;169.00;93'328.99;
09.11.2022;09.11.2022;" Tusidedescurunt / Sta.-An. 4375074528 Syllium Sertant VI ";;179.00;93'159.99;
09.11.2022;09.11.2022;" Tusidedescurunt / Sta.-An. 8048667272 Syllium Sertant VI ";;129.00;92'980.99;
09.11.2022;09.11.2022;" Tusidedescurunt / Sta.-An. 6112768847 Syllium Sertant VI ";;119.00;92'851.99;
09.11.2022;09.11.2022;" Tusidedescurunt / Sta.-An. 8623365115 Syllium Sertant VI ";;62.00;92'732.99;
09.11.2022;09.11.2022;" Tusidedescurunt / Sta.-An. 8710521454 Syllium Sertant VI ";;105.00;92'670.99;
09.11.2022;09.11.2022;" Tusidedescurunt / Sta.-An. 4562556680 Syllium Sertant VI ";;27.00;92'565.99;
09.11.2022;09.11.2022;" Tusidedescurunt / Sta.-An. 1242388712 Syllium Sertant VI ";;129.00;92'538.99;
09.11.2022;09.11.2022;" Tusidedescurunt / Sta.-An. 1122271067 Syllium Sertant VI ";;99.00;92'409.99;
09.11.2022;09.11.2022;" Tusidedescurunt / Sta.-An. 1211525165 Syllium Sertant VI ";;79.00;92'310.99;
09.11.2022;09.11.2022;" Tusidedescurunt / Sta.-An. 8745086230 Syllium Sertant VI ";;35.00;92'231.99;
09.11.2022;09.11.2022;" Tusidedescurunt / Sta.-An. 5731785443 Syllium Sertant VI ";;29.00;92'196.99;
09.11.2022;09.11.2022;" Tusidedescurunt / Sta.-An. 6702088366 Syllium Sertant VI ";;99.00;92'167.99;
09.11.2022;09.11.2022;" Tusidedescurunt / Sta.-An. 5651755775 Syllium Sertant VI ";;349.00;92'068.99;
09.11.2022;09.11.2022;" Tusidedescurunt / Sta.-An. 6504518877 Syllium Sertant VI ";;34.89;91'719.99;
09.11.2022;09.11.2022;" Tusidedescurunt / Sta.-An. 5604775861 Syllium Sertant VI ";;69.00;91'685.10;
09.11.2022;09.11.2022;" Tusidedescurunt / Sta.-An. 5407827483 Syllium Sertant VI ";;929.00;91'616.10;
09.11.2022;09.11.2022;" Tusidedescurunt / Sta.-An. 3636217200 Syllium Sertant VI ";;79.00;90'687.10;
09.11.2022;09.11.2022;" Tusidedescurunt / Sta.-An. 2785583672 Syllium Sertant VI ";;140.00;90'608.10;
09.11.2022;09.11.2022;" Tusidedescurunt / Sta.-An. 6655800411 Syllium Sertant VI ";;99.00;90'468.10;
09.11.2022;09.11.2022;" Tusidedescurunt / Sta.-An. 4506223255 VoloNerigem VI ";;286.77;90'369.10;
09.11.2022;09.11.2022;" Tusidedescurunt / Sta.-An. 3737223501 BONUM Secriduor VI ";;43.43;90'082.33;
09.11.2022;09.11.2022;" Crememperituunt v-chorope (Comisu Tirumende: 4 / Sta.-An. 8522115513) ";12'850.00;;90'038.90;
09.11.2022;09.11.2022;" Tusidedescurunt / Sta.-An. 6107282484 DECTUENEM CULCEAT VI ";;1'161.31;102'888.90;
08.11.2022;08.11.2022;" Tusidedescurunt / Sta.-An. 8528537060 BONUM Secriduor VI ";;1'140.98;101'727.59;
08.11.2022;08.11.2022;" Tusidedescurunt / Sta.-An. 8016332852 Syllium Sertant VI ";;59.90;100'586.61;
08.11.2022;08.11.2022;" Tusidedescurunt / Sta.-An. 7465708165 Syllium Sertant VI ";;179.00;100'526.71;
08.11.2022;08.11.2022;" Tusidedescurunt / Sta.-An. 8277008747 Syllium Sertant VI ";;35.00;100'347.71;
08.11.2022;08.11.2022;" Tusidedescurunt / Sta.-An. 1652810368 Syllium Sertant VI ";;179.00;100'312.71;
08.11.2022;08.11.2022;" Tusidedescurunt / Sta.-An. 8801074817 Syllium Sertant VI ";;99.00;100'133.71;
08.11.2022;08.11.2022;" Tusidedescurunt / Sta.-An. 8832666773 VoloNerigem VI ";;303.90;100'034.71;
08.11.2022;08.11.2022;" Tusidedescurunt / Sta.-An. 8827866536 BONUM Secriduor VI ";;121.11;99'730.81;
08.11.2022;08.11.2022;" Tusidedescurunt / Sta.-An. 4283187206 BONUM Secriduor VI ";;309.92;99'609.70;
08.11.2022;08.11.2022;" Tusidedescurunt / Sta.-An. 1536213615 Ceat Screm ";;1'000.00;99'299.78;
08.11.2022;06.11.2022;Orunarenti sus Morabibruntrarat MINVES *EMI6321070112 327-565-4814;1'000.00;;98'299.78;
08.11.2022;08.11.2022;" Tusidedescurunt / Sta.-An. 8256050853 DECTUENEM CULCEAT VI ";;4'706.19;99'299.78;
08.11.2022;08.11.2022;" Tusidedescurunt / Sta.-An. 6437765655 DECTUENEM CULCEAT VI ";;2'312.78;94'593.59;
08.11.2022;08.11.2022;" Tusidedescurunt / Sta.-An. 7747478414 DECTUENEM CULCEAT VI ";;831.78;92'280.81;
08.11.2022;08.11.2022;" Tusidedescurunt / Sta.-An. 6373034350 DECTUENEM CULCEAT VI ";;2'945.97;91'449.03;
08.11.2022;08.11.2022;" Peramente v-chorope / Sta.-An. 1338315084 ALIUM MOLETE SEGI ";1'703.17;;88'503.06;
08.11.2022;08.11.2022;" Tusidedescurunt / Sta.-An. 5485433166 TERIENDIERVA AT ";;1'440.27;90'206.23;
07.11.2022;07.11.2022;" Tusidedescurunt / Sta.-An. 2004255888 Syllium Sertant VI ";;35.00;88'765.96;
07.11.2022;07.11.2022;" Tusidedescurunt / Sta.-An. 4313537516 Syllium Sertant VI ";;35.00;88'730.96;
07.11.2022;07.11.2022;" Tusidedescurunt / Sta.-An. 5813317730 Syllium Sertant VI ";;32.90;88'695.96;
07.11.2022;07.11.2022;" Tusidedescurunt / Sta.-An. 3516205080 Syllium Sertant VI ";;134.00;88'663.06;
07.11.2022;07.11.2022;" Tusidedescurunt / Sta.-An. 6072556362 Syllium Sertant VI ";;99.00;88'529.06;
07.11.2022;07.11.2022;" Tusidedescurunt / Sta.-An. 6215160385 Syllium Sertant VI ";;99.00;88'430.06;
07.11.2022;07.11.2022;" Tusidedescurunt / Sta.-An. 7644878678 Syllium Sertant VI ";;99.00;88'331.06;
07.11.2022;07.11.2022;" Tusidedescurunt / Sta.-An. 8446122487 Syllium Sertant VI ";;26.90;88'232.06;
07.11.2022;07.11.2022;" Tusidedescurunt / Sta.-An. 2542847015 Syllium Sertant VI ";;99.00;88'205.16;
07.11.2022;07.11.2022;" Tusidedescurunt / Sta.-An. 6161883413 Syllium Sertant VI ";;219.00;88'106.16;
07.11.2022;07.11.2022;" Tusidedescurunt / Sta.-An. 1341861041 Syllium Sertant VI ";;69.00;87'887.16;
07.11.2022;07.11.2022;" Tusidedescurunt / Sta.-An. 3388678167 Syllium Sertant VI ";;119.90;87'818.16;
07.11.2022;07.11.2022;" Tusidedescurunt / Sta.-An. 7200266057 Syllium Sertant VI ";;35.00;87'698.26;
07.11.2022;07.11.2022;" Tusidedescurunt / Sta.-An. 6782444204 Syllium Sertant VI ";;70.00;87'663.26;
07.11.2022;07.11.2022;" Tusidedescurunt / Sta.-An. 3366158110 Syllium Sertant VI ";;35.00;87'593.26;
07.11.2022;07.11.2022;" Tusidedescurunt / Sta.-An. 3414826646 Syllium Sertant VI ";;189.00;87'558.26;
07.11.2022;07.11.2022;" Tusidedescurunt / Sta.-An. 2212161152 Syllium Sertant VI ";;439.00;87'369.26;
07.11.2022;07.11.2022;" Tusidedescurunt / Sta.-An. 2512185572 Syllium Sertant VI ";;99.00;86'930.26;
07.11.2022;07.11.2022;" Tusidedescurunt / Sta.-An. 3458860261 Syllium Sertant VI ";;99.00;86'831.26;
07.11.2022;07.11.2022;" Tusidedescurunt / Sta.-An. 3547245618 Syllium Sertant VI ";;35.00;86'732.26;
07.11.2022;07.11.2022;" Tusidedescurunt / Sta.-An. 8341634840 Syllium Sertant VI ";;35.00;86'697.26;
07.11.2022;07.11.2022;" Tusidedescurunt / Sta.-An. 4767377663 VoloNerigem VI ";;1'906.77;86'662.26;
07.11.2022;07.11.2022;" Tusidedescurunt / Sta.-An. 4771530837 BONUM Secriduor VI ";;110.45;84'755.49;
07.11.2022;07.11.2022;" Tusidedescurunt / Sta.-An. 2662773234 LATEM COMPENTIO ";;2'328.00;84'645.04;
07.11.2022;07.11.2022;" Tusidedescurunt / Sta.-An. 7605025538 Salitas Alictumendo ";;374.00;82'317.04;
07.11.2022;06.11.2022;Orunarenti sus Morabibruntrarat Pede VI Viäcossus;101.88;;81'943.04;
07.11.2022;07.11.2022;" Crememperituunt v-chorope (Comisu Tirumende: 5 / Sta.-An. 3504467046) ";1'033.62;;82'044.92;
07.11.2022;07.11.2022;" Tusidedescurunt / Sta.-An. 5162171032 DECTUENEM CULCEAT VI ";;344.89;83'078.54;
07.11.2022;07.11.2022;" Tusidedescurunt / Sta.-An. 4166556882 DECTUENEM CULCEAT VI ";;395.21;82'733.65;
07.11.2022;07.11.2022;" Peramente v-chorope / Sta.-An. 5004702803 NIAM VOLUM B.Q. ";327.37;;82'338.44;
07.11.2022;03.11.2022;Orunarenti sus Morabibruntrarat MINVES *EMI6321070112 327-565-4814;1'000.00;;82'665.81;
07.11.2022;04.11.2022;Orunarenti sus Morabibruntrarat Exit AT VI (4285) Ex;16.00;;83'665.81;
04.11.2022;04.11.2022;" Tusidedescurunt / Sta.-An. 6082073777 Syllium Sertant VI ";;49.00;83'681.81;
04.11.2022;04.11.2022;" Tusidedescurunt / Sta.-An. 3740362228 Syllium Sertant VI ";;129.00;83'632.81;
04.11.2022;04.11.2022;" Tusidedescurunt / Sta.-An. 4116851404 Syllium Sertant VI ";;664.00;83'503.81;
04.11.2022;04.11.2022;" Tusidedescurunt / Sta.-An. 7338052285 Syllium Sertant VI ";;19.90;82'839.81;
04.11.2022;04.11.2022;" Tusidedescurunt / Sta.-An. 6766125724 Syllium Sertant VI ";;209.00;82'819.91;
04.11.2022;04.11.2022;" Tusidedescurunt / Sta.-An. 2870730370 Syllium Sertant VI ";;129.00;82'610.91;
04.11.2022;04.11.2022;" Tusidedescurunt / Sta.-An. 4511567668 Syllium Sertant VI ";;69.00;82'481.91;
04.11.2022;04.11.2022;" Tusidedescurunt / Sta.-An. 7035845058 Syllium Sertant VI ";;474.00;82'412.91;
04.11.2022;04.11.2022;" Tusidedescurunt / Sta.-An. 1462518487 Syllium Sertant VI ";;99.00;81'938.91;
04.11.2022;04.11.2022;" Tusidedescurunt / Sta.-An. 1456032036 Syllium Sertant VI ";;39.00;81'839.91;
04.11.2022;04.11.2022;" Tusidedescurunt / Sta.-An. 7278444605 Syllium Sertant VI ";;79.00;81'800.91;
04.11.2022;04.11.2022;" Tusidedescurunt / Sta.-An. 8352768484 Syllium Sertant VI ";;69.00;81'721.91;
04.11.2022;04.11.2022;" Tusidedescurunt / Sta.-An. 5433744826 Syllium Sertant VI ";;169.00;81'652.91;
04.11.2022;04.11.2022;" Tusidedescurunt / Sta.-An. 2830571863 Syllium Sertant VI ";;175.00;81'483.91;
04.11.2022;04.11.2022;" Tusidedescurunt / Sta.-An. 4208555451 BONUM Secriduor VI ";;661.89;81'308.91;
04.11.2022;04.11.2022;" Crememperituunt v-chorope (Comisu Tirumende: 2 / Sta.-An. 7307834526) ";4'186.58;;80'647.02;
04.11.2022;04.11.2022;" Tusidedescurunt / Sta.-An. 5170473478 DECTUENEM CULCEAT VI ";;209.88;84'833.60;
04.11.2022;04.11.2022;" Tusidedescurunt / Sta.-An. 2827405841 DECTUENEM CULCEAT VI ";;606.00;84'623.72;
04.11.2022;04.11.2022;" Peramente v-chorope / Sta.-An. 5001105744 UNCIUM DICAT LIBRUCI SEGI ";236.66;;84'017.72;
03.11.2022;03.11.2022;" Tusidedescurunt / Sta.-An. 3136173314 VoloNerigem VI ";;43.43;84'254.38;
03.11.2022;01.11.2022;Orunarenti sus Morabibruntrarat MINVES *EMI6321070112 327-565-4814;290.35;;84'210.95;
03.11.2022;03.11.2022;" Tusidedescurunt / Sta.-An. 7334106127 BONUM Secriduor VI ";;132.26;84'501.30;
03.11.2022;03.11.2022;" Crememperituunt v-chorope (Comisu Tirumende: 4 / Sta.-An. 3801410666) ";3'435.66;;84'369.04;
03.11.2022;03.11.2022;" Tusidedescurunt / Sta.-An. 4616637675 DECTUENEM CULCEAT VI ";;2'381.88;87'804.70;
03.11.2022;03.11.2022;" Tusidedescurunt / Sta.-An. 1677658153 DECTUENEM CULCEAT VI ";;450.09;85'422.82;
03.11.2022;03.11.2022;" Peramente v-chorope / Sta.-An. 4500272618 V. AMILIA HIUNT F/B ";2'506.46;;84'972.73;
02.11.2022;02.11.2022;Expernem-Conumendit 57861304 - RIT Pier;;1'400.00;87'479.19;
02.11.2022;02.11.2022;" Tusidedescurunt / Sta.-An. 7384878037 Syllium Sertant VI ";;95.00;86'079.19;
02.11.2022;02.11.2022;" Tusidedescurunt / Sta.-An. 4600043282 Syllium Sertant VI ";;409.00;85'984.19;
02.11.2022;02.11.2022;" Tusidedescurunt / Sta.-An. 4822182043 Syllium Sertant VI ";;99.00;85'575.19;
02.11.2022;02.11.2022;" Tusidedescurunt / Sta.-An. 5005804486 Syllium Sertant VI ";;59.00;85'476.19;
02.11.2022;02.11.2022;" Tusidedescurunt / Sta.-An. 2366773328 Syllium Sertant VI ";;329.00;85'417.19;
02.11.2022;02.11.2022;" Tusidedescurunt / Sta.-An. 6532578182 Syllium Sertant VI ";;149.00;85'088.19;
02.11.2022;02.11.2022;" Tusidedescurunt / Sta.-An. 4625736515 Syllium Sertant VI ";;234.00;84'939.19;
02.11.2022;02.11.2022;" Tusidedescurunt / Sta.-An. 6312322026 Syllium Sertant VI ";;699.01;84'705.19;
02.11.2022;02.11.2022;" Tusidedescurunt / Sta.-An. 1486772280 Syllium Sertant VI ";;89.00;84'006.18;
02.11.2022;02.11.2022;" Tusidedescurunt / Sta.-An. 6765722745 Syllium Sertant VI ";;99.00;83'917.18;
02.11.2022;02.11.2022;" Tusidedescurunt / Sta.-An. 4536685721 Syllium Sertant VI ";;59.00;83'818.18;
02.11.2022;02.11.2022;" Tusidedescurunt / Sta.-An. 5764732168 Syllium Sertant VI ";;99.00;83'759.18;
02.11.2022;02.11.2022;" Tusidedescurunt / Sta.-An. 3800450634 Syllium Sertant VI ";;129.00;83'660.18;
02.11.2022;02.11.2022;" Tusidedescurunt / Sta.-An. 5744671147 Syllium Sertant VI ";;95.00;83'531.18;
02.11.2022;02.11.2022;" Tusidedescurunt / Sta.-An. 8385441210 Syllium Sertant VI ";;89.00;83'436.18;
02.11.2022;02.11.2022;" Tusidedescurunt / Sta.-An. 2158437743 Syllium Sertant VI ";;49.00;83'347.18;
02.11.2022;02.11.2022;" Tusidedescurunt / Sta.-An. 4773257801 Syllium Sertant VI ";;99.00;83'298.18;
02.11.2022;02.11.2022;" Tusidedescurunt / Sta.-An. 6034807118 Syllium Sertant VI ";;169.00;83'199.18;
02.11.2022;02.11.2022;" Tusidedescurunt / Sta.-An. 8468763243 Syllium Sertant VI ";;459.00;83'030.18;
02.11.2022;02.11.2022;" Tusidedescurunt / Sta.-An. 2262541135 Syllium Sertant VI ";;129.00;82'571.18;
02.11.2022;02.11.2022;" Tusidedescurunt / Sta.-An. 6640760868 Syllium Sertant VI ";;349.00;82'442.18;
02.11.2022;31.10.2022;Orunarenti sus Morabibruntrarat MINVES *EMI6321070112 327-565-4814;1'000.00;;82'093.18;
02.11.2022;02.11.2022;" Tusidedescurunt / Sta.-An. 6281413005 BONUM Secriduor VI ";;254.45;83'093.18;
02.11.2022;02.11.2022;" Peramente v-chorope / Sta.-An. 5152246562 ALIUM MOLETE SEGI ";2'961.81;;82'838.73;
01.11.2022;01.11.2022;" Secelegitiatuiem (Comisu Tirumende: 7 / Sta.-An. 7760568805) ";;668.00;85'800.54;
01.11.2022;01.11.2022;Expernem-Conumendit 57861304 - RIT Pier;;2'900.00;85'132.54;
01.11.2022;01.11.2022;" Tusidedescurunt / Sta.-An. 3305527501 BONUM Secriduor VI ";;116.47;82'232.54;
01.11.2022;01.11.2022;" Tusidedescurunt / Sta.-An. 2815745112 Syllium Sertant VI ";;359.00;82'116.07;
01.11.2022;01.11.2022;" Tusidedescurunt / Sta.-An. 8318611666 Syllium Sertant VI ";;95.00;81'757.07;
01.11.2022;01.11.2022;" Tusidedescurunt / Sta.-An. 4524841531 Syllium Sertant VI ";;129.00;81'662.07;
01.11.2022;01.11.2022;" Tusidedescurunt / Sta.-An. 6636126861 Syllium Sertant VI ";;609.00;81'533.07;
01.11.2022;01.11.2022;" Tusidedescurunt / Sta.-An. 5547388843 Syllium Sertant VI ";;99.00;80'924.07;
01.11.2022;01.11.2022;" Tusidedescurunt / Sta.-An. 4205215143 Syllium Sertant VI ";;32.90;80'825.07;
01.11.2022;01.11.2022;" Tusidedescurunt / Sta.-An. 6230852866 Syllium Sertant VI ";;49.00;80'792.17;
01.11.2022;01.11.2022;" Tusidedescurunt / Sta.-An. 3517531056 Syllium Sertant VI ";;49.00;80'743.17;
01.11.2022;01.11.2022;" Tusidedescurunt / Sta.-An. 5554867502 Syllium Sertant VI ";;147.00;80'694.17;
01.11.2022;01.11.2022;" Tusidedescurunt / Sta.-An. 2560231856 Syllium Sertant VI ";;1'758.00;80'547.17;
01.11.2022;01.11.2022;" Tusidedescurunt / Sta.-An. 3443616600 Syllium Sertant VI ";;349.00;78'789.17;
01.11.2022;01.11.2022;" Tusidedescurunt / Sta.-An. 1823270221 Syllium Sertant VI ";;99.00;78'440.17;
01.11.2022;01.11.2022;" Tusidedescurunt / Sta.-An. 3285818771 Syllium Sertant VI ";;459.00;78'341.17;
01.11.2022;01.11.2022;" Tusidedescurunt / Sta.-An. 8343260532 Syllium Sertant VI ";;139.00;77'882.17;
01.11.2022;01.11.2022;" Crememperituunt v-chorope (Comisu Tirumende: 4 / Sta.-An. 5585331277) ";7'377.60;;77'743.17;
01.11.2022;01.11.2022;" Tusidedescurunt / Sta.-An. 2137505440 BONUM Secriduor VI ";;460.93;85'120.77;
01.11.2022;28.10.2022;Orunarenti sus Morabibruntrarat MINVES *EMI6321070112 327-565-4814;1'000.00;;84'659.84;
01.11.2022;28.10.2022;Orunarenti sus Morabibruntrarat Unti Tentam AT Pectom ET;157.40;;85'659.84;
01.11.2022;01.11.2022;" Crememperituunt v-chorope (Comisu Tirumende: 4 / Sta.-An. 7148066821) ";7'172.38;;85'817.24;
01.11.2022;01.11.2022;" Tusidedescurunt / Sta.-An. 8345205062 DECTUENEM CULCEAT VI ";;6'052.19;92'989.62;
01.11.2022;01.11.2022;" Tusidedescurunt / Sta.-An. 5245302347 DECTUENEM CULCEAT VI ";;892.58;86'937.43;
01.11.2022;01.11.2022;" Tusidedescurunt / Sta.-An. 1810440177 TERIENDIERVA AT ";;402.46;86'044.85;
01.11.2022;01.11.2022;" Tusidedescurunt / Sta.-An. 8677288152 TERIENDIERVA AT ";;552.94;85'642.39;
31.10.2022;31.10.2022;" Secelegitiatuiem (Comisu Tirumende: 5 / Sta.-An. 4313033631) ";;892.00;85'089.45;
31.10.2022;31.10.2022;" Tusidedescurunt / Sta.-An. 6530242641 Syllium Sertant VI ";;79.00;84'197.45;
31.10.2022;31.10.2022;" Tusidedescurunt / Sta.-An. 7840821857 Syllium Sertant VI ";;26.90;84'118.45;
31.10.2022;31.10.2022;" Tusidedescurunt / Sta.-An. 6617224147 Syllium Sertant VI ";;259.00;84'091.55;
31.10.2022;31.10.2022;" Tusidedescurunt / Sta.-An. 6768882024 Syllium Sertant VI ";;557.00;83'832.55;
31.10.2022;31.10.2022;" Üholvent nem 3711.1051.8222 Dixitquila Parget SegI / Sta.-An. 4875771048 ";1'300.00;;83'275.55;
31.10.2022;31.10.2022;" Tusidedescurunt / Sta.-An. 3670145168 BONUM Secriduor VI ";;258.59;84'575.55;
31.10.2022;31.10.2022;" Peramente v-chorope / Sta.-An. 7414522150 MUM VENEIS ";2'200.00;;84'316.96;
31.10.2022;31.10.2022;" Crememperituunt v-chorope (Comisu Tirumende: 5 / Sta.-An. 2234402045) ";19'573.57;;86'516.96;
31.10.2022;31.10.2022;" Crememperituunt v-chorope (Comisu Tirumende: 4 / Sta.-An. 1213533344) ";1'359.94;;106'090.53;
31.10.2022;31.10.2022;" Tusidedescurunt / Sta.-An. 7271654831 Milecto SegI ";;333.00;107'450.47;
31.10.2022;31.10.2022;" Tusidedescurunt / Sta.-An. 6044124476 Dixitquila Parget SegI ";;169.00;107'117.47;
31.10.2022;31.10.2022;" Tusidedescurunt / Sta.-An. 6062551387 DECTUENEM CULCEAT VI ";;235.51;106'948.47;
31.10.2022;31.10.2022;" Tusidedescurunt / Sta.-An. 1466522434 DECTUENEM CULCEAT VI ";;1'414.41;106'712.96;
31.10.2022;31.10.2022;" Tusidedescurunt / Sta.-An. 6868324704 Frisu sus Quituor Minforsicat ";;194.00;105'298.55;
31.10.2022;31.10.2022;" Tusidedescurunt / Sta.-An. 7541318712 VoloNerigem VI ";;1'142.95;105'104.55;
31.10.2022;31.10.2022;" Tusidedescurunt / Sta.-An. 1724137374 VoloNerigem VI ";;318.34;103'961.60;
28.10.2022;28.10.2022;" Secelegitiatuiem (Comisu Tirumende: 4 / Sta.-An. 3630552018) ";;7'390.00;103'643.26;
28.10.2022;28.10.2022;" Tusidedescurunt / Sta.-An. 6323567116 Aurent Uniblia ";;299.00;96'253.26;
28.10.2022;28.10.2022;" Tusidedescurunt / Sta.-An. 6283870322 Syllium Sertant VI ";;35.00;95'954.26;
28.10.2022;28.10.2022;" Tusidedescurunt / Sta.-An. 3624043816 Syllium Sertant VI ";;35.00;95'919.26;
28.10.2022;28.10.2022;" Tusidedescurunt / Sta.-An. 8034302541 Syllium Sertant VI ";;349.00;95'884.26;
28.10.2022;28.10.2022;" Tusidedescurunt / Sta.-An. 4046556166 Syllium Sertant VI ";;29.90;95'535.26;
28.10.2022;28.10.2022;" Tusidedescurunt / Sta.-An. 7311770831 Syllium Sertant VI ";;79.00;95'505.36;
28.10.2022;28.10.2022;" Tusidedescurunt / Sta.-An. 7664088448 Syllium Sertant VI ";;79.00;95'426.36;
28.10.2022;28.10.2022;" Tusidedescurunt / Sta.-An. 3763635741 Syllium Sertant VI ";;129.00;95'347.36;
28.10.2022;28.10.2022;" Tusidedescurunt / Sta.-An. 4578770176 Syllium Sertant VI ";;299.00;95'218.36;
28.10.2022;28.10.2022;" Tusidedescurunt / Sta.-An. 8833722164 Syllium Sertant VI ";;49.00;94'919.36;
28.10.2022;28.10.2022;" Tusidedescurunt / Sta.-An. 2735253760 Syllium Sertant VI ";;359.00;94'870.36;
28.10.2022;28.10.2022;" Tusidedescurunt / Sta.-An. 8654308852 Syllium Sertant VI ";;99.00;94'511.36;
28.10.2022;28.10.2022;" Tusidedescurunt / Sta.-An. 2505816202 Syllium Sertant VI ";;559.00;94'412.36;
28.10.2022;28.10.2022;" Tusidedescurunt / Sta.-An. 3587868015 Syllium Sertant VI ";;99.00;93'853.36;
28.10.2022;28.10.2022;" Tusidedescurunt / Sta.-An. 1316520644 Syllium Sertant VI ";;309.00;93'754.36;
28.10.2022;28.10.2022;" Tusidedescurunt / Sta.-An. 7016416350 Syllium Sertant VI ";;79.00;93'445.36;
28.10.2022;28.10.2022;" Tusidedescurunt / Sta.-An. 1728035344 Syllium Sertant VI ";;99.00;93'366.36;
28.10.2022;28.10.2022;" Tusidedescurunt / Sta.-An. 7824562275 BONUM Secriduor VI ";;787.63;93'267.36;
28.10.2022;28.10.2022;" Crememperituunt v-chorope (Comisu Tirumende: 4 / Sta.-An. 3156503502) ";7'773.45;;92'479.73;
28.10.2022;28.10.2022;" Crememperituunt v-chorope (Comisu Tirumende: 4 / Sta.-An. 1708282813) ";4'428.66;;100'253.18;
28.10.2022;26.10.2022;Orunarenti sus Morabibruntrarat MINVES *EMI6321070112 327-565-4814;1'000.00;;104'681.84;
28.10.2022;28.10.2022;" Peramente v-chorope / Sta.-An. 7685445770 AMPERINGE PAURBIES VENEIS NUMINCH DUXORTUREM ";840.00;;105'681.84;
28.10.2022;28.10.2022;" Peramente v-chorope / Sta.-An. 3321347608 ";694.75;;106'521.84;
28.10.2022;27.10.2022;Orunarenti sus Morabibruntrarat Pere Natum;55.00;;107'216.59;
28.10.2022;27.10.2022;Orunarenti sus Morabibruntrarat VI Sione Hülion Pier;105.28;;107'271.59;
28.10.2022;28.10.2022;" Tusidedescurunt / Sta.-An. 4051386726 TERIENDIERVA AT ";;4'797.10;107'376.87;
28.10.2022;28.10.2022;" Tusidedescurunt / Sta.-An. 4624677767 DECTUENEM CULCEAT VI ";;769.10;102'579.77;
28.10.2022;28.10.2022;" Tusidedescurunt / Sta.-An. 2812656776 DECTUENEM CULCEAT VI ";;927.93;101'810.67;
27.10.2022;26.10.2022;Orunarenti sus Morabibruntrarat Sugaré Telliquae AT;10.00;;100'882.74;
27.10.2022;27.10.2022;" Tusidedescurunt / Sta.-An. 5513062615 DECTUENEM CULCEAT VI ";;2'894.08;100'892.74;
27.10.2022;27.10.2022;" Peramente v-chorope / Sta.-An. 8386136318 NWSVO82.STA VI ";4'415.70;;97'998.66;
27.10.2022;27.10.2022;" Peramente v-chorope / Sta.-An. 2520421672 V. AMILIA HIUNT F/B ";2'528.81;;102'414.36;
27.10.2022;27.10.2022;" Tusidedescurunt / Sta.-An. 1842386486 Puperis sus Netuum Audis ";;2'800.00;104'943.17;
27.10.2022;27.10.2022;" Tusidedescurunt / Sta.-An. 8368121620 Sale Sed Luvitionias sus Holo Pratuunt Samente Prevale Nentiors ";;1'468.00;102'143.17;
27.10.2022;27.10.2022;" Tusidedescurunt / Sta.-An. 5431632102 Ceat Screm ";;1'000.00;100'675.17;
26.10.2022;26.10.2022;" Secelegitiatuiem (Comisu Tirumende: 7 / Sta.-An. 4366355672) ";;89.00;99'675.17;
26.10.2022;26.10.2022;Expernem-Conumendit 62682660 - RIT Putum, 45K-Obar;;400.00;99'586.17;
26.10.2022;26.10.2022;Expernem-Conumendit 62682660 - RIT Putum, 45K-Obar;;1.00;99'186.17;
26.10.2022;26.10.2022;" Tusidedescurunt / Sta.-An. 1530137560 VoloNerigem VI ";;1'371.93;99'185.17;
26.10.2022;26.10.2022;" Tusidedescurunt / Sta.-An. 4058320057 BONUM Secriduor VI ";;142.13;97'813.24;
25.10.2022;25.10.2022;" Secelegitiatuiem (Comisu Tirumende: 4 / Sta.-An. 8632463135) ";;1'600.00;97'671.11;
25.10.2022;25.10.2022;" Tusidedescurunt / Sta.-An. 3372465684 Syllium Sertant VI ";;79.00;96'071.11;
25.10.2022;25.10.2022;" Tusidedescurunt / Sta.-An. 4111516672 Syllium Sertant VI ";;59.90;95'992.11;
25.10.2022;25.10.2022;" Tusidedescurunt / Sta.-An. 5168874636 Syllium Sertant VI ";;199.00;95'932.21;
25.10.2022;25.10.2022;" Tusidedescurunt / Sta.-An. 2528003844 Syllium Sertant VI ";;69.00;95'733.21;
25.10.2022;25.10.2022;" Tusidedescurunt / Sta.-An. 5482713216 Syllium Sertant VI ";;129.00;95'664.21;
25.10.2022;25.10.2022;" Tusidedescurunt / Sta.-An. 7382721148 Syllium Sertant VI ";;259.00;95'535.21;
25.10.2022;25.10.2022;" Tusidedescurunt / Sta.-An. 7725370450 Syllium Sertant VI ";;115.00;95'276.21;
25.10.2022;25.10.2022;" Tusidedescurunt / Sta.-An. 5011480787 Syllium Sertant VI ";;169.00;95'161.21;
25.10.2022;25.10.2022;" Tusidedescurunt / Sta.-An. 7108871004 Syllium Sertant VI ";;99.00;94'992.21;
25.10.2022;25.10.2022;" Tusidedescurunt / Sta.-An. 2734747154 Syllium Sertant VI ";;199.00;94'893.21;
25.10.2022;25.10.2022;" Tusidedescurunt / Sta.-An. 2876884804 Syllium Sertant VI ";;139.80;94'694.21;
25.10.2022;25.10.2022;" Tusidedescurunt / Sta.-An. 5563703577 Syllium Sertant VI ";;129.00;94'554.41;
25.10.2022;25.10.2022;" Tusidedescurunt / Sta.-An. 6047057667 Syllium Sertant VI ";;99.00;94'425.41;
25.10.2022;25.10.2022;" Tusidedescurunt / Sta.-An. 8558168614 Syllium Sertant VI ";;149.00;94'326.41;
25.10.2022;25.10.2022;" Tusidedescurunt / Sta.-An. 2510045633 Syllium Sertant VI ";;638.99;94'177.41;
25.10.2022;25.10.2022;" Tusidedescurunt / Sta.-An. 6143074215 Syllium Sertant VI ";;836.00;93'538.42;
25.10.2022;25.10.2022;" Tusidedescurunt / Sta.-An. 6546506565 Syllium Sertant VI ";;409.00;92'702.42;
25.10.2022;25.10.2022;" Tusidedescurunt / Sta.-An. 6726063331 Syllium Sertant VI ";;39.00;92'293.42;
25.10.2022;25.10.2022;" Tusidedescurunt / Sta.-An. 7065464028 Syllium Sertant VI ";;99.00;92'254.42;
25.10.2022;25.10.2022;" Tusidedescurunt / Sta.-An. 6800221134 Syllium Sertant VI ";;99.00;92'155.42;
25.10.2022;25.10.2022;" Tusidedescurunt / Sta.-An. 3871485042 Syllium Sertant VI ";;89.00;92'056.42;
25.10.2022;25.10.2022;" Tusidedescurunt / Sta.-An. 1483561054 TERIENDIERVA AT ";;4'443.46;91'967.42;
25.10.2022;25.10.2022;" Tusidedescurunt / Sta.-An. 6351178728 BONUM Secriduor VI ";;343.48;87'523.96;
25.10.2022;23.10.2022;Orunarenti sus Morabibruntrarat MINVES *EMI6321070112 327-565-4814;1'000.00;;87'180.48;
25.10.2022;25.10.2022;" Peramente v-chorope / Sta.-An. 5548851460 SYLLIUM SERTANT VI ";3'957.41;;88'180.48;
25.10.2022;25.10.2022;" Tusidedescurunt / Sta.-An. 7831711036 BONUM Secriduor VI ";;38.49;92'137.89;
25.10.2022;25.10.2022;" Tusidedescurunt / Sta.-An. 1261605447 BONUM Secriduor VI ";;188.41;92'099.40;
25.10.2022;25.10.2022;" Tusidedescurunt / Sta.-An. 7886067448 DECTUENEM CULCEAT VI ";;774.89;91'910.99;
25.10.2022;25.10.2022;" Tusidedescurunt / Sta.-An. 2030663334 DECTUENEM CULCEAT VI ";;5'484.19;91'136.10;
25.10.2022;25.10.2022;" Tusidedescurunt / Sta.-An. 8758146151 DECTUENEM CULCEAT VI ";;1'353.59;85'651.91;
24.10.2022;24.10.2022;" Tusidedescurunt / Sta.-An. 7201175086 Pectum Fercus ";;2'768.00;84'298.32;
24.10.2022;24.10.2022;" Tusidedescurunt / Sta.-An. 7810673222 Syllium Sertant VI ";;89.00;81'530.32;
24.10.2022;24.10.2022;" Tusidedescurunt / Sta.-An. 5258500828 Syllium Sertant VI ";;129.00;81'441.32;
24.10.2022;24.10.2022;" Tusidedescurunt / Sta.-An. 4178486287 Syllium Sertant VI ";;129.00;81'312.32;
24.10.2022;24.10.2022;" Tusidedescurunt / Sta.-An. 4228584628 Syllium Sertant VI ";;469.00;81'183.32;
24.10.2022;24.10.2022;" Tusidedescurunt / Sta.-An. 5755014355 Syllium Sertant VI ";;26.90;80'714.32;
24.10.2022;24.10.2022;" Tusidedescurunt / Sta.-An. 1760265183 Syllium Sertant VI ";;99.00;80'687.42;
24.10.2022;24.10.2022;" Crememperituunt v-chorope (Comisu Tirumende: 4 / Sta.-An. 3344144613) ";3'160.75;;80'588.42;
24.10.2022;24.10.2022;" Tusidedescurunt / Sta.-An. 2128484750 DECTUENEM CULCEAT VI ";;82.78;83'749.17;
24.10.2022;24.10.2022;" Tusidedescurunt / Sta.-An. 8684753105 Inquae Tulatorsit ";;2'450.00;83'666.39;
24.10.2022;24.10.2022;" Tusidedescurunt / Sta.-An. 5102522286 VoloNerigem VI ";;38.77;81'216.39;
24.10.2022;24.10.2022;" Tusidedescurunt / Sta.-An. 2021317515 VoloNerigem VI ";;34.54;81'177.62;
24.10.2022;20.10.2022;Orunarenti sus Morabibruntrarat MINVES *EMI6321070112 327-565-4814;1'000.00;;81'143.08;
21.10.2022;21.10.2022;" Tusidedescurunt / Sta.-An. 8606106534 Syllium Sertant VI ";;99.00;82'143.08;
21.10.2022;21.10.2022;" Tusidedescurunt / Sta.-An. 1664352385 Syllium Sertant VI ";;115.00;82'044.08;
21.10.2022;21.10.2022;" Tusidedescurunt / Sta.-An. 7353134740 Syllium Sertant VI ";;79.00;81'929.08;
21.10.2022;21.10.2022;" Tusidedescurunt / Sta.-An. 7625558050 Syllium Sertant VI ";;129.00;81'850.08;
21.10.2022;21.10.2022;" Tusidedescurunt / Sta.-An. 1604017225 Syllium Sertant VI ";;79.00;81'721.08;
21.10.2022;21.10.2022;" Tusidedescurunt / Sta.-An. 3227621771 Syllium Sertant VI ";;209.00;81'642.08;
21.10.2022;21.10.2022;" Tusidedescurunt / Sta.-An. 4718611502 Syllium Sertant VI ";;69.00;81'433.08;
21.10.2022;21.10.2022;" Tusidedescurunt / Sta.-An. 4003344000 Syllium Sertant VI ";;250.00;81'364.08;
21.10.2022;21.10.2022;" Tusidedescurunt / Sta.-An. 3283664303 VoloNerigem VI ";;298.77;81'114.08;
21.10.2022;21.10.2022;" Tusidedescurunt / Sta.-An. 8653444534 BONUM Secriduor VI ";;124.07;80'815.31;
21.10.2022;21.10.2022;" Crememperituunt v-chorope (Comisu Tirumende: 4 / Sta.-An. 6361878644) ";2'757.39;;80'691.24;
21.10.2022;21.10.2022;" Peramente v-chorope / Sta.-An. 3318316838 CAURRE INO ";2'248.85;;83'448.63;
21.10.2022;21.10.2022;" Peramente v-chorope / Sta.-An. 4654422466 ET PAGNIMO RIERE D/ SEPATIUNDISTRUM ";512.80;;85'697.48;
20.10.2022;20.10.2022;" Tusidedescurunt / Sta.-An. 3243844453 BONUM Secriduor VI ";;88.73;86'210.28;
20.10.2022;19.10.2022;Orunarenti sus Morabibruntrarat Menti-Flura VI 5187;55.40;;86'121.55;
20.10.2022;20.10.2022;" Tusidedescurunt / Sta.-An. 6874626058 DECTUENEM CULCEAT VI ";;956.35;86'176.95;
20.10.2022;20.10.2022;" Peramente v-chorope / Sta.-An. 4556812884 V. AMILIA HIUNT F/B ";2'496.30;;85'220.60;
20.10.2022;20.10.2022;" Peramente v-chorope / Sta.-An. 2564448707 SYLLIUM SERTANT VI ";735.00;;87'716.90;
20.10.2022;20.10.2022;" Tusidedescurunt / Sta.-An. 8145362334 Dedduobar VETE SegI ";;1'671.20;88'451.90;
19.10.2022;19.10.2022;Expernem-Conumendit 57861304 - RIT Pier;;280.00;86'780.70;
19.10.2022;19.10.2022;" Tusidedescurunt / Sta.-An. 4578872324 Syllium Sertant VI ";;99.00;86'500.70;
19.10.2022;19.10.2022;" Tusidedescurunt / Sta.-An. 5314422185 Syllium Sertant VI ";;249.00;86'401.70;
19.10.2022;19.10.2022;" Tusidedescurunt / Sta.-An. 8528778734 Syllium Sertant VI ";;129.00;86'152.70;
19.10.2022;19.10.2022;" Tusidedescurunt / Sta.-An. 8572404487 Syllium Sertant VI ";;99.00;86'023.70;
19.10.2022;19.10.2022;" Tusidedescurunt / Sta.-An. 4417237054 Syllium Sertant VI ";;649.00;85'924.70;
19.10.2022;19.10.2022;" Tusidedescurunt / Sta.-An. 3333163612 Syllium Sertant VI ";;169.00;85'275.70;
19.10.2022;19.10.2022;" Tusidedescurunt / Sta.-An. 7018652206 Syllium Sertant VI ";;69.90;85'106.70;
19.10.2022;19.10.2022;" Tusidedescurunt / Sta.-An. 6536761777 Syllium Sertant VI ";;35.00;85'036.80;
19.10.2022;19.10.2022;" Tusidedescurunt / Sta.-An. 8628067316 Syllium Sertant VI ";;99.00;85'001.80;
19.10.2022;19.10.2022;" Tusidedescurunt / Sta.-An. 4381015318 Syllium Sertant VI ";;29.00;84'902.80;
19.10.2022;19.10.2022;" Tusidedescurunt / Sta.-An. 2025501575 Syllium Sertant VI ";;99.00;84'873.80;
19.10.2022;19.10.2022;" Tusidedescurunt / Sta.-An. 8685425823 Syllium Sertant VI ";;129.00;84'774.80;
19.10.2022;19.10.2022;" Tusidedescurunt / Sta.-An. 2077406554 Syllium Sertant VI ";;69.78;84'645.80;
19.10.2022;19.10.2022;" Tusidedescurunt / Sta.-An. 2640344344 Syllium Sertant VI ";;35.00;84'576.02;
19.10.2022;19.10.2022;" Tusidedescurunt / Sta.-An. 3077721605 CANT - GAR SEGI ";;7'794.56;84'541.02;
19.10.2022;19.10.2022;" Tusidedescurunt / Sta.-An. 7635676242 CARAER QUE DIT ";;1'064.96;76'746.46;
19.10.2022;18.10.2022;Orunarenti sus Morabibruntrarat MINVES *EMI6321070112 327-565-4814;1'000.00;;75'681.50;
19.10.2022;19.10.2022;" Crememperituunt v-chorope (Comisu Tirumende: 2 / Sta.-An. 8045816563) ";1'707.00;;76'681.50;
19.10.2022;19.10.2022;" Peramente v-chorope / Sta.-An. 8805884602 NIAM VOLUM B.Q. ";3'239.83;;78'388.50;
19.10.2022;19.10.2022;" Tusidedescurunt / Sta.-An. 7868740076 Agnituunt Quaepe ocus Puluune ";;148.00;81'628.33;
19.10.2022;19.10.2022;" Tusidedescurunt / Sta.-An. 2068624263 Cortury Fabens ";;558.00;81'480.33;
18.10.2022;18.10.2022;" Tusidedescurunt / Sta.-An. 7467141487 BONUM Secriduor VI ";;319.79;80'922.33;
18.10.2022;18.10.2022;" Tusidedescurunt / Sta.-An. 4161773825 Syllium Sertant VI ";;729.00;80'602.54;
18.10.2022;18.10.2022;" Tusidedescurunt / Sta.-An. 5711580324 Syllium Sertant VI ";;89.00;79'873.54;
18.10.2022;18.10.2022;" Tusidedescurunt / Sta.-An. 5081713356 Syllium Sertant VI ";;589.00;79'784.54;
18.10.2022;18.10.2022;" Tusidedescurunt / Sta.-An. 3618422003 Syllium Sertant VI ";;1'396.00;79'195.54;
18.10.2022;18.10.2022;" Tusidedescurunt / Sta.-An. 4057604064 Syllium Sertant VI ";;179.00;77'799.54;
18.10.2022;18.10.2022;" Tusidedescurunt / Sta.-An. 1414472142 Syllium Sertant VI ";;99.00;77'620.54;
18.10.2022;18.10.2022;" Tusidedescurunt / Sta.-An. 7132478351 TERIENDIERVA AT ";;2'256.54;77'521.54;
18.10.2022;16.10.2022;Orunarenti sus Morabibruntrarat MINVES *EMI6321070112 327-565-4814;1'000.00;;75'265.00;
18.10.2022;18.10.2022;" Tusidedescurunt / Sta.-An. 5200610635 BONUM Secriduor VI ";;623.68;76'265.00;
18.10.2022;18.10.2022;" Tusidedescurunt / Sta.-An. 8774416627 DECTUENEM CULCEAT VI ";;6'813.41;75'641.32;
18.10.2022;18.10.2022;" Tusidedescurunt / Sta.-An. 5361845084 DECTUENEM CULCEAT VI ";;1'372.26;68'827.91;
18.10.2022;18.10.2022;" Tusidedescurunt / Sta.-An. 4167131417 DECTUENEM CULCEAT VI ";;691.11;67'455.65;
17.10.2022;17.10.2022;" Tusidedescurunt / Sta.-An. 8344633165 Syllium Sertant VI ";;129.00;66'764.54;
17.10.2022;17.10.2022;" Tusidedescurunt / Sta.-An. 7304147377 Syllium Sertant VI ";;469.00;66'635.54;
17.10.2022;17.10.2022;" Tusidedescurunt / Sta.-An. 1286225686 Syllium Sertant VI ";;99.00;66'166.54;
17.10.2022;17.10.2022;" Tusidedescurunt / Sta.-An. 8247345510 Syllium Sertant VI ";;510.00;66'067.54;
17.10.2022;17.10.2022;" Tusidedescurunt / Sta.-An. 7441073526 Syllium Sertant VI ";;99.00;65'557.54;
17.10.2022;17.10.2022;" Tusidedescurunt / Sta.-An. 2478865836 Syllium Sertant VI ";;469.00;65'458.54;
17.10.2022;17.10.2022;" Tusidedescurunt / Sta.-An. 7487118256 Syllium Sertant VI ";;169.00;64'989.54;
17.10.2022;17.10.2022;" Tusidedescurunt / Sta.-An. 5887074218 Syllium Sertant VI ";;119.00;64'820.54;
17.10.2022;17.10.2022;" Tusidedescurunt / Sta.-An. 7578262000 Syllium Sertant VI ";;129.00;64'701.54;
17.10.2022;17.10.2022;" Tusidedescurunt / Sta.-An. 5148686623 Syllium Sertant VI ";;99.00;64'572.54;
17.10.2022;17.10.2022;" Tusidedescurunt / Sta.-An. 2536465127 Syllium Sertant VI ";;49.00;64'473.54;
17.10.2022;17.10.2022;" Tusidedescurunt / Sta.-An. 1318165366 Syllium Sertant VI ";;349.00;64'424.54;
17.10.2022;17.10.2022;" Tusidedescurunt / Sta.-An. 3187863707 Syllium Sertant VI ";;79.00;64'075.54;
17.10.2022;16.10.2022;Orunarenti sus Morabibruntrarat VI Sione Hülion Pier;102.12;;63'996.54;
17.10.2022;17.10.2022;" Tusidedescurunt / Sta.-An. 6587176104 CONGENS LONE J/L ";;1'561.00;64'098.66;
17.10.2022;17.10.2022;" Tusidedescurunt / Sta.-An. 7457313282 DECTUENEM CULCEAT VI ";;3'787.33;62'537.66;
17.10.2022;17.10.2022;" Tusidedescurunt / Sta.-An. 8250300517 DECTUENEM CULCEAT VI ";;5'042.92;58'750.33;
17.10.2022;17.10.2022;" Peramente v-chorope / Sta.-An. 1233644056 COGIT COLEG SEGI ";6'712.33;;53'707.41;
17.10.2022;17.10.2022;" Tusidedescurunt / Sta.-An. 1512261844 Presex Pestas ";;115.00;60'419.74;
17.10.2022;17.10.2022;" Tusidedescurunt / Sta.-An. 2162287487 Sale Veguli Plaptum sus Holo Vigurrunt Plaptum ";;4'260.00;60'304.74;
17.10.2022;17.10.2022;" Tusidedescurunt / Sta.-An. 6617401884 VoloNerigem VI ";;707.54;56'044.74;
14.10.2022;14.10.2022;" Tusidedescurunt / Sta.-An. 6221521713 Syllium Sertant VI ";;99.00;55'337.20;
14.10.2022;14.10.2022;" Tusidedescurunt / Sta.-An. 5736385056 Syllium Sertant VI ";;59.00;55'238.20;
14.10.2022;14.10.2022;" Tusidedescurunt / Sta.-An. 4186542810 Syllium Sertant VI ";;79.00;55'179.20;
14.10.2022;14.10.2022;" Tusidedescurunt / Sta.-An. 5460646771 Syllium Sertant VI ";;89.00;55'100.20;
14.10.2022;14.10.2022;" Tusidedescurunt / Sta.-An. 5064483821 Syllium Sertant VI ";;79.00;55'011.20;
14.10.2022;14.10.2022;" Tusidedescurunt / Sta.-An. 5307464047 Sersuam Paschiunda ";;1'397.00;54'932.20;
14.10.2022;14.10.2022;" Crememperituunt v-chorope (Comisu Tirumende: 4 / Sta.-An. 6876138888) ";5'053.39;;53'535.20;
14.10.2022;14.10.2022;" Crememperituunt v-chorope (Comisu Tirumende: 4 / Sta.-An. 3542551005) ";7'115.83;;58'588.59;
13.10.2022;13.10.2022;" Tusidedescurunt / Sta.-An. 5763535241 Syllium Sertant VI ";;169.00;65'704.42;
13.10.2022;13.10.2022;" Tusidedescurunt / Sta.-An. 4122702662 Syllium Sertant VI ";;129.00;65'535.42;
13.10.2022;13.10.2022;" Tusidedescurunt / Sta.-An. 6606787751 Syllium Sertant VI ";;109.00;65'406.42;
13.10.2022;13.10.2022;" Tusidedescurunt / Sta.-An. 7151284776 Syllium Sertant VI ";;249.00;65'297.42;
13.10.2022;13.10.2022;" Tusidedescurunt / Sta.-An. 1586032868 Syllium Sertant VI ";;169.00;65'048.42;
13.10.2022;13.10.2022;" Tusidedescurunt / Sta.-An. 5255248884 VoloNerigem VI ";;90.47;64'879.42;
13.10.2022;13.10.2022;" Tusidedescurunt / Sta.-An. 2682255200 DECTUENEM CULCEAT VI ";;200.06;64'788.95;
13.10.2022;13.10.2022;" Tusidedescurunt / Sta.-An. 8342062750 DECTUENEM CULCEAT VI ";;78.15;64'588.89;
13.10.2022;13.10.2022;" Peramente v-chorope / Sta.-An. 8830833317 V. AMILIA HIUNT F/B ";2'461.64;;64'510.74;
12.10.2022;12.10.2022;" Tusidedescurunt / Sta.-An. 1142382878 Syllium Sertant VI ";;99.00;66'972.38;
12.10.2022;12.10.2022;" Tusidedescurunt / Sta.-An. 8814423080 Syllium Sertant VI ";;191.00;66'873.38;
12.10.2022;12.10.2022;" Tusidedescurunt / Sta.-An. 1547314162 Syllium Sertant VI ";;70.00;66'682.38;
12.10.2022;12.10.2022;" Tusidedescurunt / Sta.-An. 3471874788 Syllium Sertant VI ";;35.00;66'612.38;
12.10.2022;12.10.2022;" Tusidedescurunt / Sta.-An. 5426888705 Syllium Sertant VI ";;70.00;66'577.38;
12.10.2022;12.10.2022;" Tusidedescurunt / Sta.-An. 6565321872 Syllium Sertant VI ";;72.00;66'507.38;
12.10.2022;12.10.2022;" Tusidedescurunt / Sta.-An. 5064806768 Syllium Sertant VI ";;35.00;66'435.38;
12.10.2022;12.10.2022;" Tusidedescurunt / Sta.-An. 4568538277 Syllium Sertant VI ";;169.00;66'400.38;
12.10.2022;12.10.2022;" Tusidedescurunt / Sta.-An. 7542706232 Syllium Sertant VI ";;278.90;66'231.38;
12.10.2022;12.10.2022;" Tusidedescurunt / Sta.-An. 7333602837 Syllium Sertant VI ";;158.00;65'952.48;
12.10.2022;12.10.2022;" Tusidedescurunt / Sta.-An. 7260740177 Syllium Sertant VI ";;188.00;65'794.48;
12.10.2022;12.10.2022;" Tusidedescurunt / Sta.-An. 4406585878 Syllium Sertant VI ";;99.00;65'606.48;
12.10.2022;12.10.2022;" Tusidedescurunt / Sta.-An. 8780728687 Syllium Sertant VI ";;129.00;65'507.48;
12.10.2022;12.10.2022;" Tusidedescurunt / Sta.-An. 7163205182 Syllium Sertant VI ";;105.00;65'378.48;
12.10.2022;12.10.2022;" Tusidedescurunt / Sta.-An. 4213316685 Syllium Sertant VI ";;209.00;65'273.48;
12.10.2022;12.10.2022;" Tusidedescurunt / Sta.-An. 3837743178 Syllium Sertant VI ";;169.00;65'064.48;
12.10.2022;12.10.2022;" Tusidedescurunt / Sta.-An. 3114764613 Syllium Sertant VI ";;35.00;64'895.48;
12.10.2022;12.10.2022;" Peramente v-chorope / Sta.-An. 8863532474 NOCULAR-OCURA PRANT SEGI + BY. UT ";221.80;;64'860.48;
12.10.2022;12.10.2022;" Peramente v-chorope / Sta.-An. 5520303765 VENTERE PULO VI ";4'150.00;;65'082.28;
11.10.2022;11.10.2022;Expernem-Conumendit 57861304 - RIT Pier;;1'550.00;69'232.28;
11.10.2022;11.10.2022;" Tusidedescurunt / Sta.-An. 5680323106 Syllium Sertant VI ";;129.00;67'682.28;
11.10.2022;11.10.2022;" Tusidedescurunt / Sta.-An. 6738805533 Syllium Sertant VI ";;29.00;67'553.28;
11.10.2022;11.10.2022;" Tusidedescurunt / Sta.-An. 5772004511 Syllium Sertant VI ";;139.00;67'524.28;
11.10.2022;11.10.2022;" Tusidedescurunt / Sta.-An. 7854375301 Syllium Sertant VI ";;217.00;67'385.28;
11.10.2022;11.10.2022;" Tusidedescurunt / Sta.-An. 5603453378 BONUM Secriduor VI ";;132.85;67'168.28;
11.10.2022;11.10.2022;" Tusidedescurunt / Sta.-An. 2061071385 BONUM Secriduor VI ";;132.26;67'035.43;
11.10.2022;11.10.2022;" Tusidedescurunt / Sta.-An. 8854533147 TERIENDIERVA AT ";;2'454.36;66'903.17;
11.10.2022;07.10.2022;Orunarenti sus Morabibruntrarat MINVES *EMI6321070112 327-565-4814;1'000.00;;64'448.81;
11.10.2022;11.10.2022;" Tusidedescurunt / Sta.-An. 1712437101 REPERE TERUNIS ";;163.80;65'448.81;
11.10.2022;11.10.2022;" Tusidedescurunt / Sta.-An. 1356162782 DECTUENEM CULCEAT VI ";;8'358.14;65'285.01;
11.10.2022;11.10.2022;" Tusidedescurunt / Sta.-An. 8848057532 DECTUENEM CULCEAT VI ";;941.68;56'926.87;
11.10.2022;11.10.2022;" Tusidedescurunt / Sta.-An. 4030317535 DECTUENEM CULCEAT VI ";;676.05;55'985.19;
11.10.2022;11.10.2022;" Tusidedescurunt / Sta.-An. 7514062416 DECTUENEM CULCEAT VI ";;116.68;55'309.14;
11.10.2022;11.10.2022;" Tusidedescurunt / Sta.-An. 1617236855 Dixitquila Parget SegI ";;290.00;55'192.46;
11.10.2022;11.10.2022;" Peramente v-chorope / Sta.-An. 8208373123 ALIUM MOLETE SEGI ";3'739.66;;54'902.46;
10.10.2022;10.10.2022;" Tusidedescurunt / Sta.-An. 3661031473 Agro Peratris ";;850.00;58'642.12;
10.10.2022;10.10.2022;" Tusidedescurunt / Sta.-An. 5330853757 Syllium Sertant VI ";;35.00;57'792.12;
10.10.2022;10.10.2022;" Tusidedescurunt / Sta.-An. 3672581561 Syllium Sertant VI ";;129.00;57'757.12;
10.10.2022;10.10.2022;" Tusidedescurunt / Sta.-An. 6663302542 Syllium Sertant VI ";;99.00;57'628.12;
10.10.2022;10.10.2022;" Tusidedescurunt / Sta.-An. 4611363865 Syllium Sertant VI ";;409.00;57'529.12;
10.10.2022;10.10.2022;" Tusidedescurunt / Sta.-An. 4775612502 Syllium Sertant VI ";;559.00;57'120.12;
10.10.2022;10.10.2022;" Tusidedescurunt / Sta.-An. 1077732540 Syllium Sertant VI ";;99.00;56'561.12;
10.10.2022;10.10.2022;" Tusidedescurunt / Sta.-An. 6010434052 Syllium Sertant VI ";;2'098.00;56'462.12;
10.10.2022;10.10.2022;" Tusidedescurunt / Sta.-An. 8845532625 Syllium Sertant VI ";;35.00;54'364.12;
10.10.2022;10.10.2022;" Tusidedescurunt / Sta.-An. 8663355137 BONUM Secriduor VI ";;118.44;54'329.12;
10.10.2022;10.10.2022;" Crememperituunt v-chorope (Comisu Tirumende: 5 / Sta.-An. 6558755655) ";9'093.96;;54'210.68;
10.10.2022;09.10.2022;Orunarenti sus Morabibruntrarat PROTE Quituer;103.14;;63'304.64;
10.10.2022;10.10.2022;" Tusidedescurunt / Sta.-An. 8528411801 DECTUENEM CULCEAT VI ";;35.56;63'407.78;
10.10.2022;10.10.2022;" Tusidedescurunt / Sta.-An. 7614673241 VoloNerigem VI ";;1'299.77;63'372.22;
10.10.2022;06.10.2022;Orunarenti sus Morabibruntrarat Niam Volum B.Q. SORTIATUR;486.95;;62'072.45;
07.10.2022;07.10.2022;" Secelegitiatuiem (Comisu Tirumende: 7 / Sta.-An. 7558027380) ";;300.00;62'559.40;
07.10.2022;07.10.2022;" Tusidedescurunt / Sta.-An. 8851357723 Syllium Sertant VI ";;169.00;62'259.40;
07.10.2022;07.10.2022;" Tusidedescurunt / Sta.-An. 3437463254 Syllium Sertant VI ";;59.00;62'090.40;
07.10.2022;07.10.2022;" Tusidedescurunt / Sta.-An. 2285873860 Syllium Sertant VI ";;169.00;62'031.40;
07.10.2022;07.10.2022;" Tusidedescurunt / Sta.-An. 5602124501 Syllium Sertant VI ";;69.00;61'862.40;
07.10.2022;07.10.2022;" Tusidedescurunt / Sta.-An. 7501446165 Syllium Sertant VI ";;129.00;61'793.40;
07.10.2022;07.10.2022;" Tusidedescurunt / Sta.-An. 2782544634 Syllium Sertant VI ";;99.00;61'664.40;
07.10.2022;07.10.2022;" Tusidedescurunt / Sta.-An. 6202458683 Syllium Sertant VI ";;69.00;61'565.40;
07.10.2022;07.10.2022;" Tusidedescurunt / Sta.-An. 5068864424 Syllium Sertant VI ";;96.00;61'496.40;
07.10.2022;07.10.2022;" Tusidedescurunt / Sta.-An. 3763282878 Syllium Sertant VI ";;35.00;61'400.40;
07.10.2022;07.10.2022;" Tusidedescurunt / Sta.-An. 5430428752 Syllium Sertant VI ";;209.00;61'365.40;
07.10.2022;07.10.2022;" Tusidedescurunt / Sta.-An. 5424057451 Syllium Sertant VI ";;129.00;61'156.40;
07.10.2022;07.10.2022;" Tusidedescurunt / Sta.-An. 8252865620 Syllium Sertant VI ";;99.00;61'027.40;
07.10.2022;07.10.2022;" Tusidedescurunt / Sta.-An. 5013304344 Syllium Sertant VI ";;99.00;60'928.40;
07.10.2022;07.10.2022;" Tusidedescurunt / Sta.-An. 3171518870 Syllium Sertant VI ";;89.00;60'829.40;
07.10.2022;07.10.2022;" Tusidedescurunt / Sta.-An. 5064135475 Syllium Sertant VI ";;35.00;60'740.40;
07.10.2022;07.10.2022;" Tusidedescurunt / Sta.-An. 4873331688 Syllium Sertant VI ";;598.00;60'705.40;
07.10.2022;07.10.2022;" Tusidedescurunt / Sta.-An. 5208858277 Syllium Sertant VI ";;74.91;60'107.40;
07.10.2022;07.10.2022;" Tusidedescurunt / Sta.-An. 1756806026 Syllium Sertant VI ";;35.00;60'032.49;
07.10.2022;07.10.2022;" Tusidedescurunt / Sta.-An. 8330026075 Syllium Sertant VI ";;29.00;59'997.49;
07.10.2022;07.10.2022;" Tusidedescurunt / Sta.-An. 1540662013 Syllium Sertant VI ";;79.00;59'968.49;
07.10.2022;07.10.2022;" Crememperituunt v-chorope (Comisu Tirumende: 4 / Sta.-An. 6552153843) ";10'915.90;;59'889.49;
07.10.2022;07.10.2022;" Tusidedescurunt / Sta.-An. 3084683711 DECTUENEM CULCEAT VI ";;831.78;70'805.39;
07.10.2022;07.10.2022;" Peramente v-chorope / Sta.-An. 5135822567 ACTUMN COR AGNUNTI DIT NES ";6'532.06;;69'973.61;
06.10.2022;06.10.2022;" Tusidedescurunt / Sta.-An. 3157868227 BONUM Secriduor VI ";;148.05;76'505.67;
06.10.2022;05.10.2022;Orunarenti sus Morabibruntrarat Pede Quaturrura Puli;48.98;;76'357.62;
06.10.2022;06.10.2022;" Crememperituunt v-chorope (Comisu Tirumende: 2 / Sta.-An. 3338735113) ";2'179.50;;76'406.60;
06.10.2022;06.10.2022;" Tusidedescurunt / Sta.-An. 2532222554 DECTUENEM CULCEAT VI ";;7'639.12;78'586.10;
06.10.2022;06.10.2022;" Tusidedescurunt / Sta.-An. 3102311183 DECTUENEM CULCEAT VI ";;1'800.93;70'946.98;
06.10.2022;06.10.2022;" Peramente v-chorope / Sta.-An. 4238244653 V. AMILIA HIUNT F/B ";2'471.49;;69'146.05;
05.10.2022;05.10.2022;Expernem-Conumendit 57861304 - RIT Pier;;4'900.00;71'617.54;
05.10.2022;05.10.2022;" Tusidedescurunt / Sta.-An. 4143683241 Syllium Sertant VI ";;99.00;66'717.54;
05.10.2022;05.10.2022;" Tusidedescurunt / Sta.-An. 5011834458 Syllium Sertant VI ";;359.00;66'618.54;
05.10.2022;05.10.2022;" Tusidedescurunt / Sta.-An. 6564160176 Syllium Sertant VI ";;917.00;66'259.54;
05.10.2022;05.10.2022;" Tusidedescurunt / Sta.-An. 5543363074 Syllium Sertant VI ";;70.00;65'342.54;
05.10.2022;05.10.2022;" Tusidedescurunt / Sta.-An. 4232322118 Syllium Sertant VI ";;398.00;65'272.54;
05.10.2022;05.10.2022;" Tusidedescurunt / Sta.-An. 6251035401 Syllium Sertant VI ";;79.00;64'874.54;
05.10.2022;05.10.2022;" Tusidedescurunt / Sta.-An. 1600711758 Syllium Sertant VI ";;29.00;64'795.54;
05.10.2022;05.10.2022;" Tusidedescurunt / Sta.-An. 4454638100 Syllium Sertant VI ";;559.00;64'766.54;
05.10.2022;05.10.2022;" Tusidedescurunt / Sta.-An. 1276104627 Syllium Sertant VI ";;1'009.00;64'207.54;
05.10.2022;05.10.2022;" Tusidedescurunt / Sta.-An. 6618040731 Syllium Sertant VI ";;99.00;63'198.54;
05.10.2022;05.10.2022;" Tusidedescurunt / Sta.-An. 2033015016 Syllium Sertant VI ";;259.00;63'099.54;
05.10.2022;05.10.2022;" Tusidedescurunt / Sta.-An. 1287535638 Syllium Sertant VI ";;99.00;62'840.54;
05.10.2022;05.10.2022;" Tusidedescurunt / Sta.-An. 4561231737 Syllium Sertant VI ";;35.00;62'741.54;
05.10.2022;05.10.2022;" Tusidedescurunt / Sta.-An. 8322170835 Syllium Sertant VI ";;259.00;62'706.54;
05.10.2022;05.10.2022;" Tusidedescurunt / Sta.-An. 7633426244 Syllium Sertant VI ";;35.00;62'447.54;
05.10.2022;05.10.2022;" Tusidedescurunt / Sta.-An. 7636660575 Syllium Sertant VI ";;129.00;62'412.54;
05.10.2022;05.10.2022;" Tusidedescurunt / Sta.-An. 1873766550 Syllium Sertant VI ";;99.00;62'283.54;
05.10.2022;05.10.2022;" Tusidedescurunt / Sta.-An. 1500213525 Syllium Sertant VI ";;35.00;62'184.54;
05.10.2022;05.10.2022;" Tusidedescurunt / Sta.-An. 8784065730 Syllium Sertant VI ";;199.00;62'149.54;
05.10.2022;05.10.2022;" Tusidedescurunt / Sta.-An. 8061643638 Syllium Sertant VI ";;698.00;61'950.54;
05.10.2022;05.10.2022;" Tusidedescurunt / Sta.-An. 6084303408 Syllium Sertant VI ";;99.00;61'252.54;
05.10.2022;05.10.2022;" Tusidedescurunt / Sta.-An. 8312768222 Syllium Sertant VI ";;608.00;61'153.54;
05.10.2022;05.10.2022;" Tusidedescurunt / Sta.-An. 2758007833 Syllium Sertant VI ";;79.00;60'545.54;
05.10.2022;05.10.2022;" Tusidedescurunt / Sta.-An. 1134106508 Syllium Sertant VI ";;258.00;60'466.54;
05.10.2022;05.10.2022;" Tusidedescurunt / Sta.-An. 4126510747 Syllium Sertant VI ";;35.00;60'208.54;
05.10.2022;05.10.2022;" Tusidedescurunt / Sta.-An. 4723754707 Plaph Parae ocus Tegente ";;988.00;60'173.54;
05.10.2022;05.10.2022;" Peramente v-chorope / Sta.-An. 6511363118 VITA OBANUTUNT F/B ";1'301.73;;59'185.54;
05.10.2022;01.10.2022;Orunarenti sus Morabibruntrarat MINVES *EMI6321070112 327-565-4814;460.75;;60'487.27;
05.10.2022;05.10.2022;" Tusidedescurunt / Sta.-An. 1516257863 BONUM Secriduor VI ";;481.66;60'948.02;
05.10.2022;05.10.2022;" Crememperituunt v-chorope (Comisu Tirumende: 4 / Sta.-An. 8278074732) ";6'208.10;;60'466.36;
05.10.2022;05.10.2022;" Peramente v-chorope / Sta.-An. 8727346738 ADA (CULCEAT) VI ";3'347.85;;66'674.46;
04.10.2022;04.10.2022;Expernem-Conumendit 57861304 - RIT Pier;;2'130.00;70'022.31;
04.10.2022;04.10.2022;" Tusidedescurunt / Sta.-An. 8527181656 Syllium Sertant VI ";;728.60;67'892.31;
04.10.2022;04.10.2022;" Tusidedescurunt / Sta.-An. 6238241526 Syllium Sertant VI ";;559.00;67'163.71;
04.10.2022;04.10.2022;" Tusidedescurunt / Sta.-An. 5283308810 Syllium Sertant VI ";;129.00;66'604.71;
04.10.2022;04.10.2022;" Tusidedescurunt / Sta.-An. 5827460564 Syllium Sertant VI ";;35.00;66'475.71;
04.10.2022;04.10.2022;" Tusidedescurunt / Sta.-An. 2060122873 Syllium Sertant VI ";;459.00;66'440.71;
04.10.2022;04.10.2022;" Tusidedescurunt / Sta.-An. 8585561701 Syllium Sertant VI ";;79.00;65'981.71;
04.10.2022;04.10.2022;" Tusidedescurunt / Sta.-An. 1832237063 Syllium Sertant VI ";;158.00;65'902.71;
04.10.2022;04.10.2022;" Tusidedescurunt / Sta.-An. 6465217140 BONUM Secriduor VI ";;211.22;65'744.71;
04.10.2022;04.10.2022;" Tusidedescurunt / Sta.-An. 7761411775 Estræ Senterinte ";;3'600.00;65'533.49;
04.10.2022;04.10.2022;" Peramente v-chorope / Sta.-An. 7056813308 COCENS EXERE ";1'740.95;;61'933.49;
04.10.2022;04.10.2022;" Tusidedescurunt / Sta.-An. 8788115844 TERIENDIERVA AT ";;1'994.27;63'674.44;
04.10.2022;04.10.2022;" Crememperituunt v-chorope (Comisu Tirumende: 4 / Sta.-An. 7442314087) ";403.55;;61'680.17;
04.10.2022;04.10.2022;" Tusidedescurunt / Sta.-An. 6863325572 BONUM Secriduor VI ";;1'087.48;62'083.72;
04.10.2022;04.10.2022;" Tusidedescurunt / Sta.-An. 3610657060 BONUM Secriduor VI ";;2'016.44;60'996.24;
04.10.2022;04.10.2022;" Tusidedescurunt / Sta.-An. 6416777114 DECTUENEM CULCEAT VI ";;4'445.04;58'979.80;
04.10.2022;04.10.2022;" Tusidedescurunt / Sta.-An. 6362282127 DECTUENEM CULCEAT VI ";;82.36;54'534.76;
04.10.2022;04.10.2022;" Tusidedescurunt / Sta.-An. 4124780385 DECTUENEM CULCEAT VI ";;1'148.98;54'452.40;
03.10.2022;03.10.2022;" Tusidedescurunt / Sta.-An. 3062751045 Syllium Sertant VI ";;359.00;53'303.42;
03.10.2022;03.10.2022;" Tusidedescurunt / Sta.-An. 7447143425 Syllium Sertant VI ";;129.00;52'944.42;
03.10.2022;03.10.2022;" Tusidedescurunt / Sta.-An. 8264676852 Syllium Sertant VI ";;69.00;52'815.42;
03.10.2022;03.10.2022;" Tusidedescurunt / Sta.-An. 3436358374 Syllium Sertant VI ";;129.00;52'746.42;
03.10.2022;03.10.2022;" Tusidedescurunt / Sta.-An. 8666185843 Syllium Sertant VI ";;129.00;52'617.42;
03.10.2022;03.10.2022;" Tusidedescurunt / Sta.-An. 3458166317 Syllium Sertant VI ";;129.00;52'488.42;
03.10.2022;03.10.2022;" Tusidedescurunt / Sta.-An. 2410881112 Syllium Sertant VI ";;129.00;52'359.42;
03.10.2022;03.10.2022;" Tusidedescurunt / Sta.-An. 2583531711 Syllium Sertant VI ";;129.00;52'230.42;
03.10.2022;03.10.2022;" Tusidedescurunt / Sta.-An. 4026123573 Syllium Sertant VI ";;189.00;52'101.42;
03.10.2022;03.10.2022;" Peramente v-chorope / Sta.-An. 7632733287 METRO SIT TATER ";5'526.70;;51'912.42;
03.10.2022;03.10.2022;" Tusidedescurunt / Sta.-An. 7402747653 DECTUENEM CULCEAT VI ";;3'385.89;57'439.12;
03.10.2022;03.10.2022;" Tusidedescurunt / Sta.-An. 4476023552 SUBSITE SegI-Mago sex Funtubi ";;227.50;54'053.23;
03.10.2022;03.10.2022;" Tusidedescurunt / Sta.-An. 7043456228 VoloNerigem VI ";;599.77;53'825.73;
03.10.2022;28.09.2022;Orunarenti sus Morabibruntrarat Unti Tentam AT Pectom ET;158.25;;53'225.96;
30.09.2022;30.09.2022;Expettribentemüin Nomneri Fluva ********1136 37.44.4118 - 14.81.4118;9.00;;53'384.21;
30.09.2022;30.09.2022;Manareüstuieiuneüin Gulaturidix 3711.1051.8233 37.44.4118 - 14.81.4118;9.00;;53'393.21;
30.09.2022;30.09.2022;Umutabittimpus;289.20;;53'402.21;
30.09.2022;30.09.2022;Aeprormivemilicapicili;63.10;;53'691.41;
30.09.2022;30.09.2022;" Tusidedescurunt / Sta.-An. 3601424215 Malia sus Itulumn Rensi ";;4'392.00;53'754.51;
30.09.2022;30.09.2022;" Tusidedescurunt / Sta.-An. 8152385756 Syllium Sertant VI ";;89.00;49'362.51;
30.09.2022;30.09.2022;" Tusidedescurunt / Sta.-An. 4773202782 Syllium Sertant VI ";;35.00;49'273.51;
30.09.2022;30.09.2022;" Tusidedescurunt / Sta.-An. 3637526433 Syllium Sertant VI ";;99.00;49'238.51;
30.09.2022;30.09.2022;" Tusidedescurunt / Sta.-An. 6157864706 Syllium Sertant VI ";;79.00;49'139.51;
30.09.2022;30.09.2022;" Tusidedescurunt / Sta.-An. 5273662872 Syllium Sertant VI ";;129.00;49'060.51;
30.09.2022;30.09.2022;" Tusidedescurunt / Sta.-An. 4754604575 Syllium Sertant VI ";;35.00;48'931.51;
30.09.2022;30.09.2022;" Tusidedescurunt / Sta.-An. 1385278783 Syllium Sertant VI ";;309.00;48'896.51;
30.09.2022;30.09.2022;" Tusidedescurunt / Sta.-An. 4352462381 Syllium Sertant VI ";;89.00;48'587.51;
30.09.2022;30.09.2022;" Tusidedescurunt / Sta.-An. 1824634087 Syllium Sertant VI ";;658.99;48'498.51;
30.09.2022;30.09.2022;" Tusidedescurunt / Sta.-An. 7545115327 Syllium Sertant VI ";;129.00;47'839.52;
30.09.2022;30.09.2022;" Tusidedescurunt / Sta.-An. 3605403252 Syllium Sertant VI ";;389.00;47'710.52;
30.09.2022;30.09.2022;" Tusidedescurunt / Sta.-An. 8636088424 Syllium Sertant VI ";;129.00;47'321.52;
30.09.2022;30.09.2022;" Tusidedescurunt / Sta.-An. 4686177045 Syllium Sertant VI ";;240.00;47'192.52;
30.09.2022;30.09.2022;" Tusidedescurunt / Sta.-An. 5265065374 Syllium Sertant VI ";;35.90;46'952.52;
30.09.2022;30.09.2022;" Tusidedescurunt / Sta.-An. 1288703757 Syllium Sertant VI ";;309.00;46'916.62;
30.09.2022;30.09.2022;" Tusidedescurunt / Sta.-An. 2061733564 Syllium Sertant VI ";;99.00;46'607.62;
30.09.2022;30.09.2022;" Tusidedescurunt / Sta.-An. 8725587566 Syllium Sertant VI ";;35.00;46'508.62;
30.09.2022;30.09.2022;" Tusidedescurunt / Sta.-An. 8820234758 Syllium Sertant VI ";;35.00;46'473.62;
30.09.2022;30.09.2022;" Tusidedescurunt / Sta.-An. 7783635518 Syllium Sertant VI ";;129.00;46'438.62;
30.09.2022;30.09.2022;" Tusidedescurunt / Sta.-An. 6742208263 Syllium Sertant VI ";;90.00;46'309.62;
30.09.2022;30.09.2022;" Tusidedescurunt / Sta.-An. 4316073234 Syllium Sertant VI ";;89.00;46'219.62;
30.09.2022;30.09.2022;" Tusidedescurunt / Sta.-An. 5840768181 Syllium Sertant VI ";;99.00;46'130.62;
30.09.2022;30.09.2022;" Tusidedescurunt / Sta.-An. 5143183456 Syllium Sertant VI ";;409.00;46'031.62;
30.09.2022;30.09.2022;" Tusidedescurunt / Sta.-An. 8077706685 VoloNerigem VI ";;1'015.77;45'622.62;
30.09.2022;30.09.2022;Expernem-Conumendit 62682660 - RIT Putum, 45K-Obar;;15.65;44'606.85;
30.09.2022;30.09.2022;Expernem-Conumendit 62682660 - RIT Putum, 45K-Obar;;1'000.00;44'591.20;
30.09.2022;30.09.2022;" Tusidedescurunt / Sta.-An. 3337822361 BONUM Secriduor VI ";;240.83;43'591.20;
30.09.2022;30.09.2022;" Üholvent nem 3711.1051.8222 Dixitquila Parget SegI / Sta.-An. 5551553301 ";1'300.00;;43'350.37;
30.09.2022;30.09.2022;" Peramente v-chorope / Sta.-An. 8570034870 HARET FERE VI ";242.20;;44'650.37;
30.09.2022;30.09.2022;" Crememperituunt v-chorope (Comisu Tirumende: 4 / Sta.-An. 6208336126) ";15'797.96;;44'892.57;
30.09.2022;30.09.2022;" Tusidedescurunt / Sta.-An. 6152634354 Mute at/os Noster Visciurae ";;1'039.00;60'690.53;
30.09.2022;30.09.2022;" Tusidedescurunt / Sta.-An. 7773512842 DECTUENEM CULCEAT VI ";;401.17;59'651.53;
29.09.2022;28.09.2022;Orunarenti sus Morabibruntrarat MINVES *EMI6321070112 327-565-4814;1'000.00;;59'250.36;
29.09.2022;29.09.2022;" Tusidedescurunt / Sta.-An. 7250742766 DECTUENEM CULCEAT VI ";;5'763.54;60'250.36;
29.09.2022;29.09.2022;" Crememperituunt v-chorope (Comisu Tirumende: 4 / Sta.-An. 1280402685) ";3'830.65;;54'486.82;
29.09.2022;29.09.2022;" Crememperituunt v-chorope (Comisu Tirumende: 2 / Sta.-An. 4533228513) ";5'620.88;;58'317.47;
29.09.2022;29.09.2022;" Peramente v-chorope / Sta.-An. 6326666157 ";694.75;;63'938.35;
29.09.2022;29.09.2022;" Peramente v-chorope / Sta.-An. 3385468518 MALEST ALIDUM POSTRAGO ";3'543.65;;64'633.10;
28.09.2022;28.09.2022;" Tusidedescurunt / Sta.-An. 7523256050 VoloNerigem VI ";;548.54;68'176.75;
28.09.2022;28.09.2022;" Crememperituunt v-chorope (Comisu Tirumende: 4 / Sta.-An. 4333880657) ";3'958.90;;67'628.21;
28.09.2022;28.09.2022;" Crememperituunt v-chorope (Comisu Tirumende: 26 / Sta.-An. 5806288331) ";1'169.11;;71'587.11;
28.09.2022;28.09.2022;" Tusidedescurunt / Sta.-An. 8422442486 DECTUENEM CULCEAT VI ";;1'408.48;72'756.22;
28.09.2022;28.09.2022;" Tusidedescurunt / Sta.-An. 4737421122 Visper-Pernertura. Numnis ";;163.00;71'347.74;
28.09.2022;28.09.2022;" Tusidedescurunt / Sta.-An. 4363548843 Ocanenti Requam ";;609.00;71'184.74;
27.09.2022;27.09.2022;" Tusidedescurunt / Sta.-An. 3244127253 CARAER QUE DIT ";;1'914.28;70'575.74;
27.09.2022;27.09.2022;" Tusidedescurunt / Sta.-An. 1600322882 BONUM Secriduor VI ";;1'407.46;68'661.46;
27.09.2022;27.09.2022;" Tusidedescurunt / Sta.-An. 5681181183 Syllium Sertant VI ";;149.00;67'254.00;
27.09.2022;27.09.2022;" Tusidedescurunt / Sta.-An. 1701748877 Syllium Sertant VI ";;129.00;67'105.00;
27.09.2022;27.09.2022;" Tusidedescurunt / Sta.-An. 3073280388 Syllium Sertant VI ";;89.00;66'976.00;
27.09.2022;27.09.2022;" Tusidedescurunt / Sta.-An. 4807208403 Syllium Sertant VI ";;1'179.00;66'887.00;
27.09.2022;27.09.2022;" Tusidedescurunt / Sta.-An. 7407711663 Syllium Sertant VI ";;129.00;65'708.00;
27.09.2022;27.09.2022;" Tusidedescurunt / Sta.-An. 3816808137 Syllium Sertant VI ";;35.00;65'579.00;
27.09.2022;27.09.2022;" Tusidedescurunt / Sta.-An. 8008203630 Syllium Sertant VI ";;1'350.00;65'544.00;
27.09.2022;27.09.2022;" Tusidedescurunt / Sta.-An. 7233643583 Syllium Sertant VI ";;64.90;64'194.00;
27.09.2022;27.09.2022;" Tusidedescurunt / Sta.-An. 2662863434 Syllium Sertant VI ";;159.00;64'129.10;
27.09.2022;27.09.2022;" Tusidedescurunt / Sta.-An. 1840428054 Syllium Sertant VI ";;79.00;63'970.10;
27.09.2022;27.09.2022;" Tusidedescurunt / Sta.-An. 2253155445 Syllium Sertant VI ";;89.00;63'891.10;
27.09.2022;27.09.2022;" Tusidedescurunt / Sta.-An. 3206027306 Syllium Sertant VI ";;559.00;63'802.10;
27.09.2022;27.09.2022;" Tusidedescurunt / Sta.-An. 8186318168 Syllium Sertant VI ";;79.00;63'243.10;
27.09.2022;27.09.2022;" Tusidedescurunt / Sta.-An. 8720535721 Syllium Sertant VI ";;35.00;63'164.10;
27.09.2022;27.09.2022;" Tusidedescurunt / Sta.-An. 2484511343 Syllium Sertant VI ";;189.00;63'129.10;
27.09.2022;27.09.2022;" Tusidedescurunt / Sta.-An. 5444028451 Syllium Sertant VI ";;59.00;62'940.10;
27.09.2022;27.09.2022;" Tusidedescurunt / Sta.-An. 3786801202 Syllium Sertant VI ";;129.00;62'881.10;
27.09.2022;27.09.2022;" Tusidedescurunt / Sta.-An. 7318647304 Syllium Sertant VI ";;84.90;62'752.10;
27.09.2022;27.09.2022;" Tusidedescurunt / Sta.-An. 1553166002 Syllium Sertant VI ";;35.00;62'667.20;
27.09.2022;27.09.2022;" Tusidedescurunt / Sta.-An. 8377256183 Syllium Sertant VI ";;469.00;62'632.20;
27.09.2022;27.09.2022;" Tusidedescurunt / Sta.-An. 6754872828 Syllium Sertant VI ";;35.00;62'163.20;
27.09.2022;27.09.2022;" Peramente v-chorope / Sta.-An. 7086241864 BIES INO ";4'229.80;;62'128.20;
27.09.2022;27.09.2022;" Tusidedescurunt / Sta.-An. 8347320748 TERIENDIERVA AT ";;4'799.10;66'358.00;
27.09.2022;27.09.2022;" Tusidedescurunt / Sta.-An. 8401030245 TERIENDIERVA AT ";;5'388.49;61'558.90;
27.09.2022;27.09.2022;" Tusidedescurunt / Sta.-An. 5814365457 BONUM Secriduor VI ";;654.38;56'170.41;
27.09.2022;23.09.2022;Orunarenti sus Morabibruntrarat Poem Sedepro Inento Pier;43.00;;55'516.03;
27.09.2022;27.09.2022;" Tusidedescurunt / Sta.-An. 7366575760 DECTUENEM CULCEAT VI ";;332.45;55'559.03;
27.09.2022;27.09.2022;" Crememperituunt v-chorope (Comisu Tirumende: 4 / Sta.-An. 4873418716) ";610.55;;55'226.58;
27.09.2022;27.09.2022;" Tusidedescurunt / Sta.-An. 7055410503 DECTUENEM CULCEAT VI ";;3'962.96;55'837.13;
26.09.2022;26.09.2022;" Tusidedescurunt / Sta.-An. 5103058601 Syllium Sertant VI ";;89.00;51'874.17;
26.09.2022;26.09.2022;" Tusidedescurunt / Sta.-An. 2323677360 Syllium Sertant VI ";;839.00;51'785.17;
26.09.2022;26.09.2022;" Tusidedescurunt / Sta.-An. 5761667130 Syllium Sertant VI ";;89.00;50'946.17;
26.09.2022;26.09.2022;" Tusidedescurunt / Sta.-An. 2370346325 Syllium Sertant VI ";;79.00;50'857.17;
26.09.2022;26.09.2022;" Tusidedescurunt / Sta.-An. 1862718500 Syllium Sertant VI ";;189.00;50'778.17;
26.09.2022;26.09.2022;" Tusidedescurunt / Sta.-An. 6762561513 Syllium Sertant VI ";;49.00;50'589.17;
26.09.2022;26.09.2022;" Tusidedescurunt / Sta.-An. 6275772133 Syllium Sertant VI ";;70.00;50'540.17;
26.09.2022;26.09.2022;" Tusidedescurunt / Sta.-An. 5570538573 Syllium Sertant VI ";;249.00;50'470.17;
26.09.2022;26.09.2022;" Tusidedescurunt / Sta.-An. 4287482510 Syllium Sertant VI ";;59.00;50'221.17;
26.09.2022;26.09.2022;" Tusidedescurunt / Sta.-An. 2470175372 Syllium Sertant VI ";;89.00;50'162.17;
26.09.2022;26.09.2022;" Tusidedescurunt / Sta.-An. 8771478523 BONUM Secriduor VI ";;191.48;50'073.17;
26.09.2022;26.09.2022;" Peramente v-chorope / Sta.-An. 2838787354 CAURRE INO ";2'202.45;;49'881.69;
26.09.2022;26.09.2022;Expernem-Conumendit 57861304 - RIT Pier;;820.00;52'084.14;
26.09.2022;26.09.2022;" Tusidedescurunt / Sta.-An. 4564870020 Congens Salignum sus Nungita Dent ";;1'307.00;51'264.14;
26.09.2022;26.09.2022;" Crememperituunt v-chorope (Comisu Tirumende: 5 / Sta.-An. 4050830845) ";11'252.59;;49'957.14;
26.09.2022;26.09.2022;" Crememperituunt v-chorope (Comisu Tirumende: 5 / Sta.-An. 1326305387) ";7'557.10;;61'209.73;
26.09.2022;26.09.2022;" Peramente v-chorope / Sta.-An. 5440645473 NWSVO82.STA VI ";3'877.20;;68'766.83;
26.09.2022;26.09.2022;" Tusidedescurunt / Sta.-An. 8176533671 OVESTAS HIUVIT MULCHOST J/L ";;1'959.00;72'644.03;
26.09.2022;26.09.2022;" Tusidedescurunt / Sta.-An. 4622435353 DECTUENEM CULCEAT VI ";;19.71;70'685.03;
26.09.2022;26.09.2022;" Tusidedescurunt / Sta.-An. 4357211724 Patem Seculibum ";;334.00;70'665.32;
26.09.2022;26.09.2022;" Tusidedescurunt / Sta.-An. 5431515875 Xxx Aliquiury ";;1'148.00;70'331.32;
26.09.2022;24.09.2022;Orunarenti sus Morabibruntrarat Pede VI Putum;107.23;;69'183.32;
23.09.2022;23.09.2022;" Tusidedescurunt / Sta.-An. 6742302251 Syllium Sertant VI ";;89.00;69'290.55;
23.09.2022;23.09.2022;" Tusidedescurunt / Sta.-An. 2362021650 Syllium Sertant VI ";;35.00;69'201.55;
23.09.2022;23.09.2022;" Tusidedescurunt / Sta.-An. 5575877875 Syllium Sertant VI ";;35.00;69'166.55;
23.09.2022;23.09.2022;" Tusidedescurunt / Sta.-An. 4024622280 Syllium Sertant VI ";;109.00;69'131.55;
23.09.2022;23.09.2022;" Tusidedescurunt / Sta.-An. 4361770822 Syllium Sertant VI ";;119.00;69'022.55;
23.09.2022;23.09.2022;" Tusidedescurunt / Sta.-An. 4207360447 Syllium Sertant VI ";;49.00;68'903.55;
23.09.2022;23.09.2022;" Tusidedescurunt / Sta.-An. 4375376476 Syllium Sertant VI ";;70.00;68'854.55;
23.09.2022;23.09.2022;" Tusidedescurunt / Sta.-An. 7126871173 Syllium Sertant VI ";;35.00;68'784.55;
23.09.2022;23.09.2022;" Tusidedescurunt / Sta.-An. 4736140204 VoloNerigem VI ";;176.67;68'749.55;
23.09.2022;22.09.2022;Orunarenti sus Morabibruntrarat MINVES *EMI6321070112 327-565-4814;1'000.00;;68'572.88;
23.09.2022;23.09.2022;" Crememperituunt v-chorope (Comisu Tirumende: 5 / Sta.-An. 3622134666) ";8'893.09;;69'572.88;
23.09.2022;23.09.2022;" Tusidedescurunt / Sta.-An. 7656152714 BONUM Secriduor VI ";;137.00;78'465.97;
23.09.2022;23.09.2022;" Tusidedescurunt / Sta.-An. 7551656026 Nolus Conunt ";;4'120.00;78'328.97;
23.09.2022;23.09.2022;" Peramente v-chorope / Sta.-An. 8741814525 HARET FERE VI ";296.55;;74'208.97;
23.09.2022;23.09.2022;" Tusidedescurunt / Sta.-An. 3871861705 DECTUENEM CULCEAT VI ";;14.62;74'505.52;
23.09.2022;23.09.2022;" Tusidedescurunt / Sta.-An. 8850216065 Nula Gentiangeni SegI ";;153.00;74'490.90;
22.09.2022;22.09.2022;" Tusidedescurunt / Sta.-An. 5266175316 BONUM Secriduor VI ";;82.81;74'337.90;
22.09.2022;22.09.2022;" Crememperituunt v-chorope (Comisu Tirumende: 4 / Sta.-An. 4657327314) ";3'555.20;;74'255.09;
22.09.2022;22.09.2022;" Tusidedescurunt / Sta.-An. 8461415523 DECTUENEM CULCEAT VI ";;2'571.47;77'810.29;
22.09.2022;22.09.2022;" Tusidedescurunt / Sta.-An. 1414631277 DECTUENEM CULCEAT VI ";;748.36;75'238.82;
21.09.2022;21.09.2022;Expernem-Conumendit 57861304 - RIT Pier;;4'360.00;74'490.46;
21.09.2022;21.09.2022;" Tusidedescurunt / Sta.-An. 6327263770 Syllium Sertant VI ";;389.00;70'130.46;
21.09.2022;21.09.2022;" Tusidedescurunt / Sta.-An. 3717560671 Syllium Sertant VI ";;110.00;69'741.46;
21.09.2022;21.09.2022;" Tusidedescurunt / Sta.-An. 1613316767 Syllium Sertant VI ";;59.00;69'631.46;
21.09.2022;21.09.2022;" Tusidedescurunt / Sta.-An. 8158320406 Syllium Sertant VI ";;35.00;69'572.46;
21.09.2022;21.09.2022;" Tusidedescurunt / Sta.-An. 5650886634 Syllium Sertant VI ";;35.00;69'537.46;
21.09.2022;21.09.2022;" Tusidedescurunt / Sta.-An. 8587746720 Syllium Sertant VI ";;51.80;69'502.46;
21.09.2022;21.09.2022;" Tusidedescurunt / Sta.-An. 1811183228 Syllium Sertant VI ";;89.00;69'450.66;
21.09.2022;21.09.2022;" Tusidedescurunt / Sta.-An. 6362874617 Syllium Sertant VI ";;35.00;69'361.66;
21.09.2022;21.09.2022;" Tusidedescurunt / Sta.-An. 6573388573 Syllium Sertant VI ";;369.00;69'326.66;
21.09.2022;21.09.2022;" Tusidedescurunt / Sta.-An. 2242262613 Syllium Sertant VI ";;89.00;68'957.66;
21.09.2022;21.09.2022;" Tusidedescurunt / Sta.-An. 3830318857 Syllium Sertant VI ";;89.00;68'868.66;
21.09.2022;21.09.2022;" Tusidedescurunt / Sta.-An. 3422388651 Syllium Sertant VI ";;89.00;68'779.66;
21.09.2022;21.09.2022;" Tusidedescurunt / Sta.-An. 2403703654 Syllium Sertant VI ";;35.00;68'690.66;
21.09.2022;21.09.2022;" Crememperituunt v-chorope (Comisu Tirumende: 4 / Sta.-An. 1226463654) ";1'515.80;;68'655.66;
21.09.2022;21.09.2022;" Crememperituunt v-chorope (Comisu Tirumende: 2 / Sta.-An. 6786331673) ";6'104.34;;70'171.46;
21.09.2022;21.09.2022;" Tusidedescurunt / Sta.-An. 5043404161 TERIENDIERVA AT ";;4'418.17;76'275.80;
20.09.2022;20.09.2022;" Tusidedescurunt / Sta.-An. 8864207885 BONUM Secriduor VI ";;839.85;71'857.63;
20.09.2022;20.09.2022;" Tusidedescurunt / Sta.-An. 4280271685 Syllium Sertant VI ";;129.00;71'017.78;
20.09.2022;20.09.2022;" Tusidedescurunt / Sta.-An. 6647450340 Syllium Sertant VI ";;129.00;70'888.78;
20.09.2022;20.09.2022;" Tusidedescurunt / Sta.-An. 1484158348 Syllium Sertant VI ";;89.00;70'759.78;
20.09.2022;20.09.2022;" Tusidedescurunt / Sta.-An. 2347778066 Syllium Sertant VI ";;89.00;70'670.78;
20.09.2022;20.09.2022;" Tusidedescurunt / Sta.-An. 6664351163 Syllium Sertant VI ";;25.90;70'581.78;
20.09.2022;20.09.2022;" Tusidedescurunt / Sta.-An. 6213061535 Syllium Sertant VI ";;649.00;70'555.88;
20.09.2022;20.09.2022;" Tusidedescurunt / Sta.-An. 4672414151 Syllium Sertant VI ";;84.90;69'906.88;
20.09.2022;20.09.2022;" Tusidedescurunt / Sta.-An. 5685570367 Syllium Sertant VI ";;35.00;69'821.98;
20.09.2022;20.09.2022;" Tusidedescurunt / Sta.-An. 4204864275 BONUM Secriduor VI ";;907.05;69'786.98;
20.09.2022;16.09.2022;Orunarenti sus Morabibruntrarat MINVES *EMI6321070112 327-565-4814;1'000.00;;68'879.93;
20.09.2022;20.09.2022;" Tusidedescurunt / Sta.-An. 5552067204 DECTUENEM CULCEAT VI ";;443.24;69'879.93;
20.09.2022;20.09.2022;" Tusidedescurunt / Sta.-An. 1820477822 DECTUENEM CULCEAT VI ";;6'323.64;69'436.69;
20.09.2022;20.09.2022;" Crememperituunt v-chorope (Comisu Tirumende: 2 / Sta.-An. 8811755883) ";476.42;;63'113.05;
20.09.2022;20.09.2022;" Crememperituunt v-chorope (Comisu Tirumende: 4 / Sta.-An. 6417820286) ";3'097.00;;63'589.47;
20.09.2022;20.09.2022;" Tusidedescurunt / Sta.-An. 6340630361 DECTUENEM CULCEAT VI ";;858.24;66'686.47;
20.09.2022;20.09.2022;" Tusidedescurunt / Sta.-An. 2655533363 DECTUENEM CULCEAT VI ";;1'224.04;65'828.23;
20.09.2022;20.09.2022;" Tusidedescurunt / Sta.-An. 7566501843 DECTUENEM CULCEAT VI ";;230.70;64'604.19;
20.09.2022;20.09.2022;" Tusidedescurunt / Sta.-An. 8062817147 LATEM COMPENTIO ";;1'100.00;64'373.49;
19.09.2022;19.09.2022;" Tusidedescurunt / Sta.-An. 5722361682 AGRO PERATRIS ";;424.32;63'273.49;
19.09.2022;19.09.2022;" Tusidedescurunt / Sta.-An. 7344333528 Syllium Sertant VI ";;89.00;62'849.17;
19.09.2022;19.09.2022;" Tusidedescurunt / Sta.-An. 3505755032 Syllium Sertant VI ";;64.90;62'760.17;
19.09.2022;19.09.2022;" Tusidedescurunt / Sta.-An. 6501628641 Syllium Sertant VI Forotertinveniavia 70 3678 Loccit AT Scustabo: 84470711 ";;199.00;62'695.27;
19.09.2022;19.09.2022;" Tusidedescurunt / Sta.-An. 5185233324 Syllium Sertant VI Forotertinveniavia 70 3678 Loccit AT Scustabo: 45031715 ";;469.00;62'496.27;
19.09.2022;19.09.2022;" Tusidedescurunt / Sta.-An. 7515842333 Syllium Sertant VI Forotertinveniavia 70 3678 Loccit AT Scustabo: 32866805 ";;89.00;62'027.27;
19.09.2022;19.09.2022;" Tusidedescurunt / Sta.-An. 3460345111 Syllium Sertant VI Forotertinveniavia 70 3678 Loccit AT Scustabo: 16874070 ";;35.00;61'938.27;
19.09.2022;19.09.2022;" Tusidedescurunt / Sta.-An. 5816011702 Syllium Sertant VI Forotertinveniavia 70 3678 Loccit AT Scustabo: 88744600 ";;64.90;61'903.27;
19.09.2022;19.09.2022;" Tusidedescurunt / Sta.-An. 8363271166 VoloNerigem VI Tangobasciete 85 3437 Mern AT Scustabo: VOLONERIGEM P-QUAEQUE dabit://actom totenignumni.at NJWT70RT6407147 103 60658Y24478230658415 STRELL ALE 422 .13. COR ALE 7.55 ";;334.59;61'838.37;
19.09.2022;19.09.2022;" Peramente v-chorope / Sta.-An. 6653070085 POTIUM PEDIGUNDO AESTA Careperada: POPILLIS ";12'000.00;;61'503.78;
19.09.2022;19.09.2022;" Peramente v-chorope / Sta.-An. 1656237832 COGIT COLEG SEGI MUNCIRCIPARATE-ABER-INI.8 74368 MAGNIBULUVIS Careperada: CONTATURBIGATU Risino: LIS 6'233.13 Bitiaviccem: 5.366815 (LIS/ALE) ";1'719.55;;73'503.78;
19.09.2022;19.09.2022;" Peramente v-chorope / Sta.-An. 3075300381 SECTUDUNIAM SEGI RORGENTUUNIS 41 3880 DORDUCTUDO Careperada: EE17/887636 Risino: LIS 8'373.57 Bitiaviccem: 5.366815 (LIS/ALE) ";2'352.79;;75'223.33;
19.09.2022;19.09.2022;" Peramente v-chorope / Sta.-An. 3711426886 PRIS M.Q. PERVA MILLUNDUCI 38 7871 AUDABO Careperada: 7615 Risino: LIS 4'686.67 Bitiaviccem: 5.366815 (LIS/ALE) ";3'628.04;;77'576.12;
19.09.2022;19.09.2022;" Tusidedescurunt / Sta.-An. 8128321002 CERIGE FORIMOR OCUBE MICTO 26 AT 4603 DIUSTATEP Scustabo: DIVILAC 58055208 ";;844.00;81'204.16;
19.09.2022;19.09.2022;" Tusidedescurunt / Sta.-An. 4337713477 Dedduobar VETE SegI Mitantio 75 5743 Habige AT Scustabo: Retteque Sempute/SM1850422260/YX13054013/EI3/VT4848.13/IN-216.27 ";;3'670.43;80'360.16;
19.09.2022;19.09.2022;" Tusidedescurunt / Sta.-An. 7374330053 INVERECTUM FINTESSICIA J/L HOLO PICULA FINTESSICIA EX NANTULUUNT 3 AT 3318 NAVADITIRE Scustabo: INDIT 8-PUTIMPES PIA-DIDIVIT+NATUOR + PANGUNGIT AURA VESSINO ";;1'098.00;76'689.73;
19.09.2022;19.09.2022;" Tusidedescurunt / Sta.-An. 7181374682 REPERE TERUNIS HORSINTIO 2 AT 4411 PECELLAM ";;190.00;75'591.73;
19.09.2022;19.09.2022;" Tusidedescurunt / Sta.-An. 1663010084 VoloNerigem VI Tangobasciete 85 3437 Mern AT Scustabo: VOLONERIGEM ANT/PRO CALTIO 1632 Num diuniunix TC6826562226777 83632718A 36502620307135 STRELL ALE 837.13. O SI ALE 5.23 ";;199.77;75'401.73;
19.09.2022;18.09.2022;Expernem-Conumendit 57861304 - RIT Pier Nomneri Fluva Sentquobitus 28364460 75.81.4118 26:85;;1'500.00;75'201.96;
19.09.2022;16.09.2022;Orunarenti sus Morabibruntrarat In ColecIpta Nomneri Fluva Sentquobitus 28364460 23.81.4118 81:86;41.70;;73'701.96;
19.09.2022;16.09.2022;Orunarenti sus Morabibruntrarat Periple IN Tatusta Nomneri Fluva Sentquobitus 28364460 23.81.4118 23:85;52.85;;73'743.66;
16.09.2022;16.09.2022;" Tusidedescurunt / Sta.-An. 4881388621 Atudo Jubitant Suntime VI Choronifiecto 11 5861 Suntime AT ";;1'545.70;73'796.51;
16.09.2022;16.09.2022;" Tusidedescurunt / Sta.-An. 5706100808 Syllium Sertant VI Forotertinveniavia 70 3678 Loccit AT Scustabo: 86453583 ";;26.90;72'250.81;
16.09.2022;16.09.2022;" Tusidedescurunt / Sta.-An. 1683480746 Syllium Sertant VI Forotertinveniavia 70 3678 Loccit AT Scustabo: 42274536 ";;229.00;72'223.91;
16.09.2022;16.09.2022;" Tusidedescurunt / Sta.-An. 6253472170 Syllium Sertant VI Forotertinveniavia 70 3678 Loccit AT Scustabo: 51322510 ";;64.90;71'994.91;
16.09.2022;16.09.2022;" Tusidedescurunt / Sta.-An. 6522536420 Syllium Sertant VI Forotertinveniavia 70 3678 Loccit AT Scustabo: 30676661 ";;89.00;71'930.01;
16.09.2022;16.09.2022;" Tusidedescurunt / Sta.-An. 7701251040 Syllium Sertant VI Forotertinveniavia 70 3678 Loccit AT Scustabo: 58166738 ";;89.00;71'841.01;
16.09.2022;16.09.2022;" Tusidedescurunt / Sta.-An. 2244161637 Syllium Sertant VI Forotertinveniavia 70 3678 Loccit AT Scustabo: 18070126 ";;199.00;71'752.01;
16.09.2022;16.09.2022;" Tusidedescurunt / Sta.-An. 6353485418 Syllium Sertant VI Forotertinveniavia 70 3678 Loccit AT Scustabo: 25610032 ";;35.00;71'553.01;
16.09.2022;16.09.2022;" Tusidedescurunt / Sta.-An. 7413678730 Syllium Sertant VI Forotertinveniavia 70 3678 Loccit AT Scustabo: 85101041 ";;89.00;71'518.01;
16.09.2022;16.09.2022;" Tusidedescurunt / Sta.-An. 1643026274 Syllium Sertant VI Forotertinveniavia 70 3678 Loccit AT Scustabo: 46814161 ";;35.00;71'429.01;
16.09.2022;16.09.2022;" Tusidedescurunt / Sta.-An. 2324355080 Syllium Sertant VI Forotertinveniavia 70 3678 Loccit AT Scustabo: 62155852 ";;69.00;71'394.01;
16.09.2022;15.09.2022;Orunarenti sus Morabibruntrarat Pede VI Vitatusquate Nomneri Fluva Sentquobitus 28364460 31.81.4118 41:58;106.01;;71'325.01;
16.09.2022;16.09.2022;" Tusidedescurunt / Sta.-An. 2281527287 DABIT FERCUS VINQUAESTANDO 8I AT 7766 FAMANTIMI ";;2'067.00;71'431.02;
16.09.2022;16.09.2022;" Peramente v-chorope / Sta.-An. 4236323520 SECTUDUNIAM SEGI RORGENTUUNIS 41 3880 DORDUCTUDO Careperada: EE17/838736 Risino: LIS 6'276.70 Bitiaviccem: 5.353723 (LIS/ALE) ";1'927.77;;69'364.02;
16.09.2022;16.09.2022;" Peramente v-chorope / Sta.-An. 4480123816 NIAM VOLUM B.Q. FLUUNT 45-4 5046 AT LUS TESEDIATUBE Careperada: SONGENI 20537337 Risino: LIS 184.13 Bitiaviccem: 5.353723 (LIS/ALE) ";342.05;;71'291.79;
16.09.2022;16.09.2022;" Tusidedescurunt / Sta.-An. 6828444358 DECTUENEM CULCEAT VI TIANTEMPLUMQUIT 533 AT 3678 EXPECTO Scustabo: EMO / 8842.13/AN.1134755710/COR. 14.82/FUN.23.81.4118/Dixitquila Parget An/Pier ";;1'587.10;71'633.83;
16.09.2022;16.09.2022;" Tusidedescurunt / Sta.-An. 3474338118 DECTUENEM CULCEAT VI TIANTEMPLUMQUIT 533 AT 3678 EXPECTO Scustabo: EMO / 864.51/AN.2565870187/COR. 8.80/FUN.23.81.4118/Actom Totenignumni /Motudiperunt ";;136.72;70'046.73;
16.09.2022;16.09.2022;" Peramente v-chorope / Sta.-An. 2588466360 LAUDIS ERUM CANETE X'OCULO 36 7040 CANETANT ";629.88;;69'910.01;
16.09.2022;16.09.2022;" Tusidedescurunt / Sta.-An. 4850718170 Volum Varita Deribi Longitiante Gruntraestiti 23 2344 Loccit AT Scustabo: Fortubit-An.: 68451746 Cutana-An.:18031 Sculaüludiscem Fentanticuro: Paraer Menente Menente Gruntraestiti 23 2344 Loccit Culceat ";;488.00;70'539.89;
15.09.2022;15.09.2022;" Tusidedescurunt / Sta.-An. 8667184500 NOLIONEM SOLUCUS BY L'PAVICOR PATEM DICENT ITUDABO 75 AT 6180 AGNUM Scustabo: OS 46083138 / LANTIUSTERTUDO ACTOM TOTENIGNUMNI RECUNDUCENDE 76 1632 MOTUDIPERUNT ";;1'269.00;70'051.89;
15.09.2022;15.09.2022;" Tusidedescurunt / Sta.-An. 4071052525 Ascentrunt Loculasse Turieritam 7 7437 Teriem AT Scustabo: Statiarado. 84726365 ";;789.00;68'782.89;
15.09.2022;15.09.2022;" Peramente v-chorope / Sta.-An. 4303648468 HARET FERE VI ALIA PROPERCULUCENERVARE 3 1231 TABYSSIRATET Sculaüludiscem Fentanticuro: ACTOM TOTENIGNUMNI DIXITQUILA PARGET SEGI ";363.65;;67'993.89;
15.09.2022;15.09.2022;" Peramente v-chorope / Sta.-An. 3347881463 COGIT COLEG SEGI MUNCIRCIPARATE-ABER-INI.8 74368 MAGNIBULUVIS Careperada: CONTATURBIGATU + BEATICA VOCANTIAM Risino: LIS 0'233.13 Bitiaviccem: 5.501833 (LIS/ALE) ";6'598.02;;68'357.54;
14.09.2022;14.09.2022;" Tusidedescurunt / Sta.-An. 5786342624 CARAER QUE DIT SUPERIT PARE 81-37 REGATA IMULO 1 ARIGNIGIT 76376 OS 76376 Scustabo: 7250423814610 ";;1'263.33;74'955.56;
14.09.2022;12.09.2022;Orunarenti sus Morabibruntrarat MINVES *EMI6321070112 327-565-4814 RIT Parte Silevolone Sentquobitus 2077 2243 1846 6404 31.81.4118 26:80;1'000.00;;73'692.23;
14.09.2022;14.09.2022;" Tusidedescurunt / Sta.-An. 6720488532 BONUM Secriduor VI Sugavictotagindiam 55 8531 Loccit AT Scustabo: 164022 BONUM si81g4g4-50ng-2175-x36 6-32os5607h534 Faciet 13271243 Tesse: 817.51 Scro: -8.62 ";;559.44;74'692.23;
14.09.2022;14.09.2022;" Tusidedescurunt / Sta.-An. 7524567620 DECTUENEM CULCEAT VI TIANTEMPLUMQUIT 533 AT 3678 EXPECTO Scustabo: EMO / 538.51/AN.6787147441/COR. 8.81/FUN.31.81.4118/Actom Totenignumni /Motudiperunt ";;481.71;74'132.79;
14.09.2022;14.09.2022;" Peramente v-chorope / Sta.-An. 1877740762 V. AMILIA HIUNT F/B O SERIRE 23 O XXX 8453 GRECUTE Careperada: RICENDIDEVOS Risino: LIS 8'864.13 Bitiaviccem: 5.241214 (LIS/ALE) ";2'438.83;;73'651.08;
13.09.2022;13.09.2022;" Tusidedescurunt / Sta.-An. 2165063423 BONUM Secriduor VI Sugavictotagindiam 55 8531 Loccit AT Scustabo: 164022 BONUM si81g4g4-50ng-2175-x36 6-32os5607h534 Faciet 42758855 Tesse: 733.13 Scro: -6.86 ";;112.52;76'089.91;
13.09.2022;13.09.2022;" Tusidedescurunt / Sta.-An. 6833322815 Syllium Sertant VI Forotertinveniavia 70 3678 Loccit AT Scustabo: 53433647 ";;189.00;75'977.39;
13.09.2022;13.09.2022;" Tusidedescurunt / Sta.-An. 1674563332 Syllium Sertant VI Forotertinveniavia 70 3678 Loccit AT Scustabo: 26506560 ";;129.00;75'788.39;
13.09.2022;13.09.2022;" Tusidedescurunt / Sta.-An. 2148177843 Syllium Sertant VI Forotertinveniavia 70 3678 Loccit AT Scustabo: 71648770 ";;59.90;75'659.39;
13.09.2022;13.09.2022;" Tusidedescurunt / Sta.-An. 6415422785 Syllium Sertant VI Forotertinveniavia 70 3678 Loccit AT Scustabo: 58858034 ";;129.00;75'599.49;
13.09.2022;13.09.2022;" Tusidedescurunt / Sta.-An. 2670282703 Syllium Sertant VI Forotertinveniavia 70 3678 Loccit AT Scustabo: 84242065 ";;35.00;75'470.49;
13.09.2022;13.09.2022;" Tusidedescurunt / Sta.-An. 7732612427 Syllium Sertant VI Forotertinveniavia 70 3678 Loccit AT Scustabo: 56343310 ";;89.00;75'435.49;
13.09.2022;13.09.2022;" Tusidedescurunt / Sta.-An. 4137355147 Syllium Sertant VI Forotertinveniavia 70 3678 Loccit AT Scustabo: 57812077 ";;189.00;75'346.49;
13.09.2022;13.09.2022;" Tusidedescurunt / Sta.-An. 7627268386 Syllium Sertant VI Forotertinveniavia 70 3678 Loccit AT Scustabo: 13307800 ";;289.00;75'157.49;
13.09.2022;13.09.2022;" Tusidedescurunt / Sta.-An. 3113618653 Syllium Sertant VI Forotertinveniavia 70 3678 Loccit AT Scustabo: 81057518 ";;259.00;74'868.49;
13.09.2022;13.09.2022;" Tusidedescurunt / Sta.-An. 3444368720 Syllium Sertant VI Forotertinveniavia 70 3678 Loccit AT Scustabo: 38872221 ";;89.00;74'609.49;
13.09.2022;13.09.2022;" Tusidedescurunt / Sta.-An. 7557174423 Syllium Sertant VI Forotertinveniavia 70 3678 Loccit AT Scustabo: 17473672 ";;89.00;74'520.49;
13.09.2022;13.09.2022;" Tusidedescurunt / Sta.-An. 6512526872 Syllium Sertant VI Forotertinveniavia 70 3678 Loccit AT Scustabo: 22571463 ";;209.00;74'431.49;
13.09.2022;13.09.2022;" Tusidedescurunt / Sta.-An. 1587058435 Syllium Sertant VI Forotertinveniavia 70 3678 Loccit AT Scustabo: 70751824 ";;79.00;74'222.49;
13.09.2022;13.09.2022;" Tusidedescurunt / Sta.-An. 8606625467 Syllium Sertant VI Forotertinveniavia 70 3678 Loccit AT Scustabo: 16008224 ";;35.00;74'143.49;
13.09.2022;13.09.2022;" Tusidedescurunt / Sta.-An. 2007744813 Syllium Sertant VI Forotertinveniavia 70 3678 Loccit AT Scustabo: 12671226 ";;22.44;74'108.49;
13.09.2022;13.09.2022;" Tusidedescurunt / Sta.-An. 5451817835 Syllium Sertant VI Forotertinveniavia 70 3678 Loccit AT Scustabo: 74182111 ";;89.00;74'086.05;
13.09.2022;13.09.2022;" Tusidedescurunt / Sta.-An. 6401284310 Syllium Sertant VI Forotertinveniavia 70 3678 Loccit AT Scustabo: 22183856 ";;989.00;73'997.05;
13.09.2022;13.09.2022;" Tusidedescurunt / Sta.-An. 2470302301 Syllium Sertant VI Forotertinveniavia 70 3678 Loccit AT Scustabo: 43622473 ";;169.00;73'008.05;
13.09.2022;13.09.2022;" Tusidedescurunt / Sta.-An. 7184881837 Syllium Sertant VI Forotertinveniavia 70 3678 Loccit AT Scustabo: 64887444 ";;129.00;72'839.05;
13.09.2022;13.09.2022;" Tusidedescurunt / Sta.-An. 2858285518 Syllium Sertant VI Forotertinveniavia 70 3678 Loccit AT Scustabo: 34461582 ";;309.00;72'710.05;
13.09.2022;13.09.2022;" Tusidedescurunt / Sta.-An. 6360632046 Syllium Sertant VI Forotertinveniavia 70 3678 Loccit AT Scustabo: 86584040 ";;1'209.00;72'401.05;
13.09.2022;13.09.2022;" Tusidedescurunt / Sta.-An. 1427471231 Syllium Sertant VI Forotertinveniavia 70 3678 Loccit AT Scustabo: 82185821 ";;79.00;71'192.05;
13.09.2022;13.09.2022;" Tusidedescurunt / Sta.-An. 6142558544 Syllium Sertant VI Forotertinveniavia 70 3678 Loccit AT Scustabo: 55413053 ";;35.00;71'113.05;
13.09.2022;13.09.2022;" Tusidedescurunt / Sta.-An. 1205261812 TERIENDIERVA AT Tum ut Sustell 2 1471 Pectom ET AT Scustabo: Cestiury 81.81.73 - 31.81.73 ";;9'129.61;71'078.05;
13.09.2022;13.09.2022;" Tusidedescurunt / Sta.-An. 7161540481 BONUM Secriduor VI Sugavictotagindiam 55 8531 Loccit AT Scustabo: 164022 BONUM si81g4g4-50ng-2175-x36 6-32os5607h534 Faciet 71280708 Tesse: 544.51 Scro: -7.45 ";;331.43;61'948.44;
13.09.2022;10.09.2022;Orunarenti sus Morabibruntrarat MINVES *EMI6321070112 327-565-4814 RIT Parte Silevolone Sentquobitus 2077 2243 1846 6404 54.81.4118 54:23;1'000.00;;61'617.01;
13.09.2022;13.09.2022;" Tusidedescurunt / Sta.-An. 5303751243 DECTUENEM CULCEAT VI TIANTEMPLUMQUIT 533 AT 3678 EXPECTO Scustabo: EMO / 3478.13/AN.5245664431/COR. 28.84/FUN.54.81.4118/Actom Totenignumni /Motudiperunt ";;4'565.58;62'617.01;
13.09.2022;13.09.2022;" Tusidedescurunt / Sta.-An. 8767813340 DECTUENEM CULCEAT VI TIANTEMPLUMQUIT 533 AT 3678 EXPECTO Scustabo: EMO / 5130.51/AN.4155062682/COR. 62.75/FUN.81.81.4118/Dixitquila Parget An/Pier ";;2'636.62;58'051.43;
12.09.2022;12.09.2022;" Tusidedescurunt / Sta.-An. 8683353522 VoloNerigem VI Tangobasciete 85 3437 Mern AT Scustabo: VOLONERIGEM P-QUAEQUE dabit://actom totenignumni.at NJWT70RT6407147 103 50430M78434584517670 STRELL ALE 476 .51. COR ALE 6.62 ";;103.44;55'414.81;
12.09.2022;12.09.2022;Expernem-Conumendit 57861304 - RIT Pier Nomneri Fluva Sentquobitus 28364460 31.81.4118 81:23;;1'000.00;55'311.37;
12.09.2022;12.09.2022;" Tusidedescurunt / Sta.-An. 2881518036 Inget sus Stata Numen-Mortinves Parituundide 26 4364 Stiortagna Scustabo: Griannem-An.: 58455762 Xxx. Numen, Auxoractubitusa 41, 641 Aquid ";;4'900.00;54'311.37;
12.09.2022;12.09.2022;" Tusidedescurunt / Sta.-An. 5077312042 CARAER QUE DIT SUPERIT PARE 81-37 REGATA IMULO 1 ARIGNIGIT 76376 OS 76376 Scustabo: 3103310120537 ";;2'891.46;49'411.37;
12.09.2022;12.09.2022;" Tusidedescurunt / Sta.-An. 4433841523 DECTUENEM CULCEAT VI TIANTEMPLUMQUIT 533 AT 3678 EXPECTO Scustabo: EMO / 3433.82/AN.5061716544/COR. 75.45/FUN.80.81.4118/Dixitquila Parget An/Pier ";;4'631.53;46'519.91;
12.09.2022;12.09.2022;" Tusidedescurunt / Sta.-An. 7763733837 DECTUENEM CULCEAT VI TIANTEMPLUMQUIT 533 AT 3678 EXPECTO Scustabo: EMO / 8410.51/AN.7057586132/COR. 48.36/FUN.80.81.4118/Actom Totenignumni /Motudiperunt ";;2'221.35;41'888.38;
12.09.2022;12.09.2022;" Peramente v-chorope / Sta.-An. 4752125441 VENTERE PULO VI RECUNDUCENDE 76 1632 MOTUDIPERUNT Careperada: FUNGA ";4'150.00;;39'667.03;
12.09.2022;12.09.2022;" Tusidedescurunt / Sta.-An. 3046350561 Dedduobar VETE SegI Mitantio 75 5743 Habige AT Scustabo: Retteque Sempute/SM1850422260/DA06035171/EI3/UF567.13/IN-41.31 ";;366.85;43'817.03;
12.09.2022;12.09.2022;" Tusidedescurunt / Sta.-An. 6462066311 Dixitquila Parget SegI Punnerbit 72 7851 Pier AT Scustabo: Muntiora ";;657.45;43'450.18;
12.09.2022;12.09.2022;" Tusidedescurunt / Sta.-An. 3054346722 VoloNerigem VI Tangobasciete 85 3437 Mern AT Scustabo: VOLONERIGEM ANT/PRO CALTIO 1632 Num diuniunix TC6826562226777 41113377L 50760757161467 STRELL ALE 871.13. O SI ALE 5.24 ";;648.54;42'792.73;
09.09.2022;09.09.2022;" Tusidedescurunt / Sta.-An. 5022470616 Syllium Sertant VI Forotertinveniavia 70 3678 Loccit AT Scustabo: 20165677 ";;70.00;42'144.19;
09.09.2022;09.09.2022;" Tusidedescurunt / Sta.-An. 7112685406 Syllium Sertant VI Forotertinveniavia 70 3678 Loccit AT Scustabo: 33801014 ";;129.00;42'074.19;
09.09.2022;09.09.2022;" Tusidedescurunt / Sta.-An. 4272865328 Syllium Sertant VI Forotertinveniavia 70 3678 Loccit AT Scustabo: 38023071 ";;329.00;41'945.19;
09.09.2022;09.09.2022;" Tusidedescurunt / Sta.-An. 3863886546 Syllium Sertant VI Forotertinveniavia 70 3678 Loccit AT Scustabo: 32133388 ";;189.00;41'616.19;
09.09.2022;09.09.2022;" Tusidedescurunt / Sta.-An. 7264846086 Syllium Sertant VI Forotertinveniavia 70 3678 Loccit AT Scustabo: 75158828 ";;189.00;41'427.19;
09.09.2022;09.09.2022;" Tusidedescurunt / Sta.-An. 8572860022 Syllium Sertant VI Forotertinveniavia 70 3678 Loccit AT Scustabo: 57208787 ";;70.00;41'238.19;
09.09.2022;09.09.2022;" Tusidedescurunt / Sta.-An. 2437211074 Syllium Sertant VI Forotertinveniavia 70 3678 Loccit AT Scustabo: 26588637 ";;35.00;41'168.19;
09.09.2022;09.09.2022;" Tusidedescurunt / Sta.-An. 1681776646 Syllium Sertant VI Forotertinveniavia 70 3678 Loccit AT Scustabo: 73121080 ";;309.00;41'133.19;
09.09.2022;09.09.2022;" Tusidedescurunt / Sta.-An. 7343863753 Syllium Sertant VI Forotertinveniavia 70 3678 Loccit AT Scustabo: 18226576 ";;144.00;40'824.19;
09.09.2022;09.09.2022;" Tusidedescurunt / Sta.-An. 1231015828 Syllium Sertant VI Forotertinveniavia 70 3678 Loccit AT Scustabo: 87302668 ";;79.00;40'680.19;
09.09.2022;09.09.2022;" Tusidedescurunt / Sta.-An. 4070412087 Syllium Sertant VI Forotertinveniavia 70 3678 Loccit AT Scustabo: 72552868 ";;309.00;40'601.19;
09.09.2022;09.09.2022;" Tusidedescurunt / Sta.-An. 4388834400 Syllium Sertant VI Forotertinveniavia 70 3678 Loccit AT Scustabo: 71487727 ";;35.00;40'292.19;
09.09.2022;09.09.2022;" Tusidedescurunt / Sta.-An. 2432621614 Syllium Sertant VI Forotertinveniavia 70 3678 Loccit AT Scustabo: 71270072 ";;349.00;40'257.19;
09.09.2022;09.09.2022;" Tusidedescurunt / Sta.-An. 6681838766 Syllium Sertant VI Forotertinveniavia 70 3678 Loccit AT Scustabo: 33348554 ";;35.00;39'908.19;
09.09.2022;09.09.2022;" Tusidedescurunt / Sta.-An. 2800573260 Syllium Sertant VI Forotertinveniavia 70 3678 Loccit AT Scustabo: 26178343 ";;129.00;39'873.19;
09.09.2022;09.09.2022;" Tusidedescurunt / Sta.-An. 5770760843 Syllium Sertant VI Forotertinveniavia 70 3678 Loccit AT Scustabo: 73305861 ";;35.00;39'744.19;
09.09.2022;09.09.2022;" Tusidedescurunt / Sta.-An. 8843010228 Syllium Sertant VI Forotertinveniavia 70 3678 Loccit AT Scustabo: 76572720 ";;89.00;39'709.19;
09.09.2022;09.09.2022;" Tusidedescurunt / Sta.-An. 6768823105 Syllium Sertant VI Forotertinveniavia 70 3678 Loccit AT Scustabo: 25328431 ";;198.00;39'620.19;
09.09.2022;09.09.2022;" Tusidedescurunt / Sta.-An. 5264063173 Syllium Sertant VI Forotertinveniavia 70 3678 Loccit AT Scustabo: 70448044 ";;129.00;39'422.19;
09.09.2022;09.09.2022;" Tusidedescurunt / Sta.-An. 3746241488 Syllium Sertant VI Forotertinveniavia 70 3678 Loccit AT Scustabo: 88816666 ";;349.00;39'293.19;
09.09.2022;09.09.2022;" Tusidedescurunt / Sta.-An. 1474753618 Syllium Sertant VI Forotertinveniavia 70 3678 Loccit AT Scustabo: 34414012 ";;169.00;38'944.19;
09.09.2022;09.09.2022;" Tusidedescurunt / Sta.-An. 8286487121 Syllium Sertant VI Forotertinveniavia 70 3678 Loccit AT Scustabo: 41738226 ";;89.00;38'775.19;
09.09.2022;09.09.2022;" Tusidedescurunt / Sta.-An. 4377152424 Syllium Sertant VI Forotertinveniavia 70 3678 Loccit AT Scustabo: 62601075 ";;24.90;38'686.19;
09.09.2022;09.09.2022;" Tusidedescurunt / Sta.-An. 4608581142 Syllium Sertant VI Forotertinveniavia 70 3678 Loccit AT Scustabo: 42825658 ";;129.00;38'661.29;
09.09.2022;09.09.2022;" Tusidedescurunt / Sta.-An. 5648633764 Syllium Sertant VI Forotertinveniavia 70 3678 Loccit AT Scustabo: 18845728 ";;89.00;38'532.29;
09.09.2022;09.09.2022;" Tusidedescurunt / Sta.-An. 5851470048 Syllium Sertant VI Forotertinveniavia 70 3678 Loccit AT Scustabo: 24874866 ";;35.00;38'443.29;
09.09.2022;09.09.2022;" Tusidedescurunt / Sta.-An. 8047376825 Syllium Sertant VI Forotertinveniavia 70 3678 Loccit AT Scustabo: 61443461 ";;89.00;38'408.29;
09.09.2022;09.09.2022;" Tusidedescurunt / Sta.-An. 3206400150 Syllium Sertant VI Forotertinveniavia 70 3678 Loccit AT Scustabo: 47133412 ";;238.00;38'319.29;
09.09.2022;09.09.2022;" Tusidedescurunt / Sta.-An. 4526237645 Syllium Sertant VI Forotertinveniavia 70 3678 Loccit AT Scustabo: 13030572 ";;209.00;38'081.29;
09.09.2022;09.09.2022;" Tusidedescurunt / Sta.-An. 2215622638 Syllium Sertant VI Forotertinveniavia 70 3678 Loccit AT Scustabo: 36732762 ";;89.00;37'872.29;
09.09.2022;08.09.2022;Orunarenti sus Morabibruntrarat MINVES *EMI6321070112 327-565-4814 RIT Parte Silevolone Sentquobitus 2077 2243 1846 6404 80.81.4118 83:27;1'000.00;;37'783.29;
09.09.2022;09.09.2022;" Tusidedescurunt / Sta.-An. 5037808144 BONUM Secriduor VI Sugavictotagindiam 55 8531 Loccit AT Scustabo: 164022 BONUM si81g4g4-50ng-2175-x36 6-32os5607h534 Faciet 16730823 Tesse: 647.13 Scro: -0.80 ";;461.92;38'783.29;
09.09.2022;09.09.2022;" Tusidedescurunt / Sta.-An. 8761384503 LOCES VOLUM ACUSTATE PROLONGULIQUINUMN 47 AT 1476 REVITUDISU ";;388.00;38'321.37;
09.09.2022;08.09.2022;Orunarenti sus Morabibruntrarat Sugaré Telliquae AT Nomneri Fluva Sentquobitus 28364460 80.81.4118 26:86;161.00;;37'933.37;
09.09.2022;09.09.2022;" Tusidedescurunt / Sta.-An. 8431168576 DECTUENEM CULCEAT VI TIANTEMPLUMQUIT 533 AT 3678 EXPECTO Scustabo: EMO / 1783.51/AN.7734180770/COR. 73.23/FUN.44.81.4118/Dixitquila Parget An/Pier ";;1'131.66;38'094.37;
09.09.2022;09.09.2022;" Tusidedescurunt / Sta.-An. 7645225372 DECTUENEM CULCEAT VI TIANTEMPLUMQUIT 533 AT 3678 EXPECTO Scustabo: EMO / 441.13/AN.1208203625/COR. 8.13/FUN.44.81.4118/Actom Totenignumni /Motudiperunt ";;597.00;36'962.71;
09.09.2022;09.09.2022;" Peramente v-chorope / Sta.-An. 6183346308 VIRUNT PARGET ADRABITI SEGI QUAESEMPECUM 23 3538 TERAECIT Careperada: POPILLIS 4574302288 ";1'135.90;;36'365.71;
08.09.2022;08.09.2022;" Tusidedescurunt BY / Sta.-An. 2860683283 Bies Ino Punnerbit 72 7851 Pier ";;1.00;37'501.61;
08.09.2022;08.09.2022;" Tusidedescurunt / Sta.-An. 1336750188 DECTUENEM CULCEAT VI TIANTEMPLUMQUIT 533 AT 3678 EXPECTO Scustabo: EMO / 6832.13/AN.2252614841/COR. 27.63/FUN.65.81.4118/Dixitquila Parget An/Pier ";;4'248.29;37'500.61;
08.09.2022;08.09.2022;" Peramente v-chorope / Sta.-An. 2724170822 VITA OBANUTUNT F/B NAL 61555882 PARIDE 216 AT-7345 LOCTO Careperada: 1805451 7001001 ";842.94;;33'252.32;
08.09.2022;08.09.2022;" Tusidedescurunt / Sta.-An. 7355606404 Matemore Levent Recredisse 53 6237 Spirigundiccia Scustabo: 38817 ";;2'874.00;34'095.26;
07.09.2022;07.09.2022;" Tusidedescurunt / Sta.-An. 5861138411 Syllium Sertant VI Forotertinveniavia 70 3678 Loccit AT Scustabo: 30505430 ";;89.00;31'221.26;
07.09.2022;07.09.2022;" Tusidedescurunt / Sta.-An. 8704788441 Syllium Sertant VI Forotertinveniavia 70 3678 Loccit AT Scustabo: 14235183 ";;89.00;31'132.26;
07.09.2022;07.09.2022;" Tusidedescurunt / Sta.-An. 6184530128 Syllium Sertant VI Forotertinveniavia 70 3678 Loccit AT Scustabo: 17264351 ";;89.00;31'043.26;
07.09.2022;07.09.2022;" Tusidedescurunt / Sta.-An. 1418104724 Syllium Sertant VI Forotertinveniavia 70 3678 Loccit AT Scustabo: 34720644 ";;209.00;30'954.26;
07.09.2022;07.09.2022;" Tusidedescurunt / Sta.-An. 8144156063 Syllium Sertant VI Forotertinveniavia 70 3678 Loccit AT Scustabo: 86563623 ";;189.00;30'745.26;
07.09.2022;07.09.2022;" Tusidedescurunt / Sta.-An. 1088233106 Syllium Sertant VI Forotertinveniavia 70 3678 Loccit AT Scustabo: 71153886 ";;89.00;30'556.26;
07.09.2022;07.09.2022;" Tusidedescurunt / Sta.-An. 8116041531 Syllium Sertant VI Forotertinveniavia 70 3678 Loccit AT Scustabo: 44374175 ";;129.00;30'467.26;
07.09.2022;07.09.2022;" Tusidedescurunt / Sta.-An. 1036207026 Syllium Sertant VI Forotertinveniavia 70 3678 Loccit AT Scustabo: 86771354 ";;89.00;30'338.26;
07.09.2022;07.09.2022;" Tusidedescurunt / Sta.-An. 2206507803 Syllium Sertant VI Forotertinveniavia 70 3678 Loccit AT Scustabo: 65344688 ";;129.00;30'249.26;
07.09.2022;07.09.2022;" Tusidedescurunt / Sta.-An. 2818018220 Iptudo Ment Propus SegI Optentiustemporepe 76 6684 Loccit AT ";;119.25;30'120.26;
07.09.2022;07.09.2022;" Peramente v-chorope / Sta.-An. 6473532886 STIRCUS ANTEM 54 POR, TUM CONDIT 27228 GATUS STRIBI Careperada: PER-4118-58743 Risino: LIS 8'864.61 Bitiaviccem: 5.353525 (LIS/ALE) ";2'558.91;;30'001.01;
07.09.2022;07.09.2022;" Peramente v-chorope / Sta.-An. 5100626885 V. AMILIA HIUNT F/B O SERIRE 23 O XXX 8453 GRECUTE Careperada: RICENDIDEVOS Risino: LIS 8'864.13 Bitiaviccem: 5.353525 (LIS/ALE) ";2'480.14;;32'559.92;
07.09.2022;07.09.2022;" Peramente v-chorope / Sta.-An. 1243326574 HARET FERE VI ALIA PROPERCULUCENERVARE 3 1231 TABYSSIRATET Sculaüludiscem Fentanticuro: ACTOM TOTENIGNUMNI DIXITQUILA PARGET SEGI ";206.75;;35'040.06;
07.09.2022;07.09.2022;" Peramente v-chorope / Sta.-An. 4674420774 HARET FERE VI ALIA PROPERCULUCENERVARE 3 1231 TABYSSIRATET Sculaüludiscem Fentanticuro: ACTOM TOTENIGNUMNI DIXITQUILA PARGET SEGI ";1'016.15;;35'246.81;
07.09.2022;07.09.2022;" Peramente v-chorope / Sta.-An. 2168561852 HARET FERE VI ALIA PROPERCULUCENERVARE 3 1231 TABYSSIRATET Sculaüludiscem Fentanticuro: ACTOM TOTENIGNUMNI DIXITQUILA PARGET SEGI ";1'048.95;;36'262.96;
07.09.2022;07.09.2022;" Peramente v-chorope / Sta.-An. 3548521763 HARET FERE VI ALIA PROPERCULUCENERVARE 3 1231 TABYSSIRATET Sculaüludiscem Fentanticuro: ACTOM TOTENIGNUMNI DIXITQUILA PARGET SEGI ";1'216.75;;37'311.91;
07.09.2022;07.09.2022;" Peramente v-chorope / Sta.-An. 7462342880 POTIUM PEDIGUNDO AESTA Careperada: POPILLIS FERCUS 4118 ";10'480.00;;38'528.66;
07.09.2022;07.09.2022;" Tusidedescurunt / Sta.-An. 8228138266 DECTUENEM CULCEAT VI TIANTEMPLUMQUIT 533 AT 3678 EXPECTO Scustabo: EMO / 5117.13/AN.1205762381/COR. 7.88/FUN.33.81.4118/Actom Totenignumni /Motudiperunt ";;1'393.48;49'008.66;
07.09.2022;07.09.2022;" Tusidedescurunt / Sta.-An. 5545824234 DECTUENEM CULCEAT VI TIANTEMPLUMQUIT 533 AT 3678 EXPECTO Scustabo: EMO / 400.13/AN.2740332257/COR. 8.68/FUN.33.81.4118/Dixitquila Parget An/Pier ";;406.06;47'615.18;
06.09.2022;06.09.2022;" Peramente v-chorope / Sta.-An. 6455580557 MUM VENEIS DICIPLACTURRUNT 31 5208 PUTUM Sculaüludiscem Fentanticuro: DIXITQUILA PARGET SEGI ";45.05;;47'209.12;
06.09.2022;06.09.2022;" Tusidedescurunt / Sta.-An. 8117280600 Syllium Sertant VI Forotertinveniavia 70 3678 Loccit AT Scustabo: 57316446 ";;199.00;47'254.17;
06.09.2022;06.09.2022;" Tusidedescurunt / Sta.-An. 6128728117 Syllium Sertant VI Forotertinveniavia 70 3678 Loccit AT Scustabo: 40248238 ";;89.00;47'055.17;
06.09.2022;06.09.2022;" Tusidedescurunt / Sta.-An. 5617062226 Syllium Sertant VI Forotertinveniavia 70 3678 Loccit AT Scustabo: 24212601 ";;89.00;46'966.17;
06.09.2022;06.09.2022;" Tusidedescurunt / Sta.-An. 8678652064 Syllium Sertant VI Forotertinveniavia 70 3678 Loccit AT Scustabo: 44584163 ";;35.00;46'877.17;
06.09.2022;06.09.2022;" Tusidedescurunt / Sta.-An. 2644431850 Syllium Sertant VI Forotertinveniavia 70 3678 Loccit AT Scustabo: 17011320 ";;1'209.00;46'842.17;
06.09.2022;06.09.2022;" Tusidedescurunt / Sta.-An. 4311027825 Syllium Sertant VI Forotertinveniavia 70 3678 Loccit AT Scustabo: 87534274 ";;89.00;45'633.17;
06.09.2022;06.09.2022;" Tusidedescurunt / Sta.-An. 1482417783 Syllium Sertant VI Forotertinveniavia 70 3678 Loccit AT Scustabo: 51578352 ";;89.00;45'544.17;
06.09.2022;06.09.2022;" Tusidedescurunt / Sta.-An. 4526622536 Syllium Sertant VI Forotertinveniavia 70 3678 Loccit AT Scustabo: 74618585 ";;48.00;45'455.17;
06.09.2022;06.09.2022;" Tusidedescurunt / Sta.-An. 3188410212 Syllium Sertant VI Forotertinveniavia 70 3678 Loccit AT Scustabo: 14046355 ";;129.00;45'407.17;
06.09.2022;06.09.2022;" Tusidedescurunt / Sta.-An. 3530511688 Syllium Sertant VI Forotertinveniavia 70 3678 Loccit AT Scustabo: 76766823 ";;35.00;45'278.17;
06.09.2022;06.09.2022;" Tusidedescurunt / Sta.-An. 3638145522 TERIENDIERVA AT Tum ut Sustell 2 1471 Pectom ET AT Scustabo: 37311137 ";;1'051.18;45'243.17;
06.09.2022;06.09.2022;" Tusidedescurunt / Sta.-An. 7705808016 TERIENDIERVA AT Tum ut Sustell 2 1471 Pectom ET AT Scustabo: 57530381 ";;407.02;44'191.99;
06.09.2022;06.09.2022;" Tusidedescurunt / Sta.-An. 4403204066 TERIENDIERVA AT Tum ut Sustell 2 1471 Pectom ET AT Scustabo: 41041061 ";;1'244.14;43'784.97;
06.09.2022;06.09.2022;" Tusidedescurunt / Sta.-An. 7265332025 TERIENDIERVA AT Tum ut Sustell 2 1471 Pectom ET AT Scustabo: 32083880 ";;380.14;42'540.83;
06.09.2022;06.09.2022;" Tusidedescurunt / Sta.-An. 4706151162 TERIENDIERVA AT Tum ut Sustell 2 1471 Pectom ET AT Scustabo: 52452515 ";;1'002.22;42'160.69;
06.09.2022;06.09.2022;" Tusidedescurunt / Sta.-An. 4255573482 TERIENDIERVA AT Tum ut Sustell 2 1471 Pectom ET AT Scustabo: Cestiury 83.81.73 - 80.81.73 ";;703.91;41'158.47;
06.09.2022;06.09.2022;" Tusidedescurunt / Sta.-An. 1625044042 BONUM Secriduor VI Sugavictotagindiam 55 8531 Loccit AT Scustabo: 164022 BONUM si81g4g4-50ng-2175-x36 6-32os5607h534 Faciet 64727128 Tesse: 814.13 Scro: -1.80 ";;665.24;40'454.56;
06.09.2022;06.09.2022;" Tusidedescurunt / Sta.-An. 2775018223 BONUM Secriduor VI Sugavictotagindiam 55 8531 Loccit AT Scustabo: 164022 BONUM si81g4g4-50ng-2175-x36 6-32os5607h534 Faciet 15585738 Tesse: 685.13 Scro: -7.67 ";;324.72;39'789.32;
06.09.2022;06.09.2022;" Tusidedescurunt / Sta.-An. 2565001072 BONUM Secriduor VI Sugavictotagindiam 55 8531 Loccit AT Scustabo: 164022 BONUM si81g4g4-50ng-2175-x36 6-32os5607h534 Faciet 47485616 Tesse: 845.13 Scro: -6.57 ";;413.55;39'464.60;
06.09.2022;04.09.2022;Orunarenti sus Morabibruntrarat MINVES *EMI6321070112 327-565-4814 RIT Parte Silevolone Sentquobitus 2077 2243 1846 6404 86.81.4118 31:43;1'000.00;;39'051.05;
06.09.2022;06.09.2022;" Tusidedescurunt / Sta.-An. 3681782636 DECTUENEM CULCEAT VI TIANTEMPLUMQUIT 533 AT 3678 EXPECTO Scustabo: EMO / 4233.62/AN.1308611744/COR. 55.15/FUN.38.81.4118/Actom Totenignumni /Motudiperunt ";;6'420.19;40'051.05;
06.09.2022;06.09.2022;" Peramente v-chorope / Sta.-An. 8235772761 HARET FERE VI ALIA PROPERCULUCENERVARE 3 1231 TABYSSIRATET Sculaüludiscem Fentanticuro: ACTOM TOTENIGNUMNI DIXITQUILA PARGET SEGI ";1'609.00;;33'630.86;
06.09.2022;06.09.2022;" Peramente v-chorope / Sta.-An. 7033582304 COCENS EXERE ASSULUM 41N 4224 PRIBENTENTE Careperada: CONE FERCUS ";1'906.00;;35'239.86;
06.09.2022;06.09.2022;" Peramente v-chorope / Sta.-An. 6542624244 IMULUCENDUSTERE ORTABELINTINUTUS ÆDITAMILLIGE 18 1320 MERN ";4'113.05;;37'145.86;
06.09.2022;06.09.2022;" Tusidedescurunt / Sta.-An. 2208281714 DECTUENEM CULCEAT VI TIANTEMPLUMQUIT 533 AT 3678 EXPECTO Scustabo: EMO / 158.54/AN.2376801187/COR. 4.47/FUN.83.81.4118/Dixitquila Parget An/Pier ";;199.19;41'258.91;
05.09.2022;05.09.2022;" Tusidedescurunt / Sta.-An. 5142555581 Syllium Sertant VI Forotertinveniavia 70 3678 Loccit AT Scustabo: 70618482 ";;70.00;41'059.72;
05.09.2022;05.09.2022;" Tusidedescurunt / Sta.-An. 5662243588 Syllium Sertant VI Forotertinveniavia 70 3678 Loccit AT Scustabo: 82153433 ";;89.00;40'989.72;
05.09.2022;05.09.2022;" Tusidedescurunt / Sta.-An. 5371704483 Syllium Sertant VI Forotertinveniavia 70 3678 Loccit AT Scustabo: 41401072 ";;189.00;40'900.72;
05.09.2022;05.09.2022;" Tusidedescurunt / Sta.-An. 1162706607 Syllium Sertant VI Forotertinveniavia 70 3678 Loccit AT Scustabo: 37782020 ";;89.00;40'711.72;
05.09.2022;05.09.2022;" Tusidedescurunt / Sta.-An. 1352605275 Syllium Sertant VI Forotertinveniavia 70 3678 Loccit AT Scustabo: 36143321 ";;35.00;40'622.72;
05.09.2022;05.09.2022;" Tusidedescurunt / Sta.-An. 8114311845 Syllium Sertant VI Forotertinveniavia 70 3678 Loccit AT Scustabo: 78036844 ";;348.00;40'587.72;
05.09.2022;05.09.2022;" Tusidedescurunt / Sta.-An. 8071467427 Syllium Sertant VI Forotertinveniavia 70 3678 Loccit AT Scustabo: 62040451 ";;35.00;40'239.72;
05.09.2022;05.09.2022;" Tusidedescurunt / Sta.-An. 4883735523 ADRATER UBIERE L'ALIGE PONERCIEINTUNIUM 871 AT 7652 LOCCIT Scustabo: INSAN AT 40685841 ";;1'317.00;40'204.72;
05.09.2022;05.09.2022;" Tusidedescurunt / Sta.-An. 6546543653 BONUM Secriduor VI Sugavictotagindiam 55 8531 Loccit AT Scustabo: 164022 BONUM si81g4g4-50ng-2175-x36 6-32os5607h534 Faciet 18682360 Tesse: 4543.18 Scro: -48.48 ";;2'578.74;38'887.72;
05.09.2022;05.09.2022;" Peramente v-chorope / Sta.-An. 4425888072 INATERIAM ACURAPERE PRAERAT Careperada: BSC07-4620106 Risino: LIS 242.48 Bitiaviccem: 5.740402 (LIS/ALE) ";922.85;;36'308.98;
05.09.2022;05.09.2022;" Peramente v-chorope / Sta.-An. 4140187632 HARET FERE VI ALIA PROPERCULUCENERVARE 3 1231 TABYSSIRATET Sculaüludiscem Fentanticuro: ACTOM TOTENIGNUMNI DIXITQUILA PARGET SEGI ";48.30;;37'231.83;
05.09.2022;05.09.2022;" Peramente v-chorope / Sta.-An. 6184005608 HARET FERE VI ALIA PROPERCULUCENERVARE 3 1231 TABYSSIRATET Sculaüludiscem Fentanticuro: ACTOM TOTENIGNUMNI DIXITQUILA PARGET SEGI ";238.45;;37'280.13;
05.09.2022;05.09.2022;" Peramente v-chorope / Sta.-An. 7556232338 HARET FERE VI ALIA PROPERCULUCENERVARE 3 1231 TABYSSIRATET Sculaüludiscem Fentanticuro: ACTOM TOTENIGNUMNI DIXITQUILA PARGET SEGI ";32.60;;37'518.58;
05.09.2022;05.09.2022;" Peramente v-chorope / Sta.-An. 4087073018 HARET FERE VI ALIA PROPERCULUCENERVARE 3 1231 TABYSSIRATET Sculaüludiscem Fentanticuro: ACTOM TOTENIGNUMNI DIXITQUILA PARGET SEGI ";406.95;;37'551.18;
05.09.2022;05.09.2022;" Peramente v-chorope / Sta.-An. 3516446636 HARET FERE VI ALIA PROPERCULUCENERVARE 3 1231 TABYSSIRATET Sculaüludiscem Fentanticuro: ACTOM TOTENIGNUMNI DIXITQUILA PARGET SEGI ";40.85;;37'958.13;
05.09.2022;05.09.2022;" Peramente v-chorope / Sta.-An. 1116817628 SOLO PLAM SEGI 6836 AGNUM Careperada: 67715 ";188.00;;37'998.98;
05.09.2022;05.09.2022;" Peramente v-chorope / Sta.-An. 3501312761 VIRUNT PARGET ADRABITI SEGI QUAESEMPECUM 23 3538 TERAECIT Careperada: SUPA SOLO 7855002264 ";25.00;;38'186.98;
05.09.2022;05.09.2022;" Peramente v-chorope / Sta.-An. 7653376358 FUILLIGE SEGI 6634 OCTIAVIVIO EX PARE Careperada: 7134834 ";968.27;;38'211.98;
05.09.2022;05.09.2022;" Peramente v-chorope / Sta.-An. 4783521047 HARET FERE VI ALIA PROPERCULUCENERVARE 3 1231 TABYSSIRATET Sculaüludiscem Fentanticuro: ACTOM TOTENIGNUMNI DIXITQUILA PARGET SEGI ";844.35;;39'180.25;
05.09.2022;05.09.2022;" Peramente v-chorope / Sta.-An. 4066213544 HARET FERE VI ALIA PROPERCULUCENERVARE 3 1231 TABYSSIRATET Sculaüludiscem Fentanticuro: ACTOM TOTENIGNUMNI DIXITQUILA PARGET SEGI ";459.25;;40'024.60;
05.09.2022;05.09.2022;" Tusidedescurunt / Sta.-An. 5361857117 DECTUENEM CULCEAT VI TIANTEMPLUMQUIT 533 AT 3678 EXPECTO Scustabo: EMO / 7850.13/AN.4065724327/COR. 45.44/FUN.37.81.4118/Dixitquila Parget An/Pier ";;1'910.93;40'483.85;
05.09.2022;05.09.2022;" Tusidedescurunt / Sta.-An. 7383637133 Contum Exiles VI Inetuducciderves 4 7218 Rintem Scustabo: OS 42821053 ";;1'769.45;38'572.92;
05.09.2022;05.09.2022;" Tusidedescurunt / Sta.-An. 4441565521 Putudas Saerte Esec Mercusquoncet 24 6382 Expecto AT ";;25.00;36'803.47;
05.09.2022;05.09.2022;" Tusidedescurunt / Sta.-An. 1121312674 Habsintio Sugaterm Biecidestrimila 15 5727 Uxervo Scustabo: MOR: RPVFUT56 ";;747.00;36'778.47;
05.09.2022;05.09.2022;" Tusidedescurunt / Sta.-An. 1032377657 Pracit Vicentest Morsultimeditabo 31 6131 Agnum AT Scustabo: Horiputudigem .74765 ";;1'238.00;36'031.47;
05.09.2022;05.09.2022;" Tusidedescurunt / Sta.-An. 7757161730 Melis Ventitant Sticipsireserusa 13H 5861 Ripsimile VI Scustabo: Derunde que Andabet 40574683 Cutana-An. 88061 ";;1'700.00;34'793.47;
05.09.2022;05.09.2022;" Tusidedescurunt / Sta.-An. 4853870344 VoloNerigem VI Tangobasciete 85 3437 Mern AT Scustabo: VOLONERIGEM ANT/PRO CALTIO 1632 Num diuniunix TC6826562226777 46261525L 63134600038120 STRELL ALE 15.51. ME O ALE 5.23 ";;31.57;33'093.47;
05.09.2022;04.09.2022;Expernem-Conumendit 57861304 - RIT Pier Nomneri Fluva Sentquobitus 28364460 86.81.4118 54:62;;800.00;33'061.90;
05.09.2022;01.09.2022;Orunarenti sus Morabibruntrarat MINVES *EMI6321070112 327-565-4814 RIT Parte Silevolone Sentquobitus 2077 2243 1846 6404 37.81.4118 23:62;748.75;;32'261.90;
02.09.2022;02.09.2022;" Tusidedescurunt / Sta.-An. 8503875330 Syllium Sertant VI Forotertinveniavia 70 3678 Loccit AT Scustabo: 17700430 ";;99.00;33'010.65;
02.09.2022;02.09.2022;" Tusidedescurunt / Sta.-An. 5175222560 Syllium Sertant VI Forotertinveniavia 70 3678 Loccit AT Scustabo: 50482338 ";;238.00;32'911.65;
02.09.2022;02.09.2022;" Tusidedescurunt / Sta.-An. 3153724762 Syllium Sertant VI Forotertinveniavia 70 3678 Loccit AT Scustabo: 56687241 ";;35.00;32'673.65;
02.09.2022;02.09.2022;" Tusidedescurunt / Sta.-An. 7863671845 Syllium Sertant VI Forotertinveniavia 70 3678 Loccit AT Scustabo: 30046760 ";;129.00;32'638.65;
02.09.2022;02.09.2022;" Tusidedescurunt / Sta.-An. 3262382876 Syllium Sertant VI Forotertinveniavia 70 3678 Loccit AT Scustabo: 30860264 ";;129.00;32'509.65;
02.09.2022;02.09.2022;" Tusidedescurunt / Sta.-An. 4248177371 Syllium Sertant VI Forotertinveniavia 70 3678 Loccit AT Scustabo: 24266172 ";;35.00;32'380.65;
02.09.2022;02.09.2022;" Tusidedescurunt / Sta.-An. 7225731683 Syllium Sertant VI Forotertinveniavia 70 3678 Loccit AT Scustabo: 28730740 ";;109.00;32'345.65;
02.09.2022;02.09.2022;" Tusidedescurunt / Sta.-An. 1648887663 Syllium Sertant VI Forotertinveniavia 70 3678 Loccit AT Scustabo: 10048576 ";;79.00;32'236.65;
02.09.2022;02.09.2022;" Tusidedescurunt / Sta.-An. 2287832101 Syllium Sertant VI Forotertinveniavia 70 3678 Loccit AT Scustabo: 21020340 ";;349.00;32'157.65;
02.09.2022;02.09.2022;" Tusidedescurunt / Sta.-An. 8117261455 Syllium Sertant VI Forotertinveniavia 70 3678 Loccit AT Scustabo: 50156742 ";;129.00;31'808.65;
02.09.2022;02.09.2022;" Tusidedescurunt / Sta.-An. 7557134372 Syllium Sertant VI Forotertinveniavia 70 3678 Loccit AT Scustabo: 45014567 ";;35.00;31'679.65;
02.09.2022;02.09.2022;" Tusidedescurunt / Sta.-An. 7064407637 Syllium Sertant VI Forotertinveniavia 70 3678 Loccit AT Scustabo: 87758456 ";;179.00;31'644.65;
02.09.2022;02.09.2022;" Tusidedescurunt / Sta.-An. 6078413266 Syllium Sertant VI Forotertinveniavia 70 3678 Loccit AT Scustabo: 26265026 ";;59.00;31'465.65;
02.09.2022;02.09.2022;" Tusidedescurunt / Sta.-An. 1130565865 Syllium Sertant VI Forotertinveniavia 70 3678 Loccit AT Scustabo: 72086152 ";;349.00;31'406.65;
02.09.2022;02.09.2022;" Tusidedescurunt / Sta.-An. 1584432258 CALIQUO AMPERUNIS VI LEBREST 41 AT 2204 MULIGAUSPUTE Scustabo: REQUOBSIT AN. 32085311 ";;214.00;31'057.65;
02.09.2022;02.09.2022;" Peramente v-chorope / Sta.-An. 5635332161 HARET FERE VI ALIA PROPERCULUCENERVARE 3 1231 TABYSSIRATET Sculaüludiscem Fentanticuro: ACTOM TOTENIGNUMNI DIXITQUILA PARGET SEGI ";396.05;;30'843.65;
02.09.2022;02.09.2022;" Peramente v-chorope / Sta.-An. 4865682633 PARTUDABO STRAE PARAESERACIT 7 7370 NOSTQUERRE Careperada: 46882114 ";489.67;;31'239.70;
02.09.2022;02.09.2022;" Peramente v-chorope / Sta.-An. 2882431647 PARTUDABO STRAE PARAESERACIT 7 7370 NOSTQUERRE Careperada: 35278126 ";246.70;;31'729.37;
02.09.2022;02.09.2022;" Peramente v-chorope / Sta.-An. 2511354415 HARET FERE VI ALIA PROPERCULUCENERVARE 3 1231 TABYSSIRATET Sculaüludiscem Fentanticuro: ACTOM TOTENIGNUMNI DIXITQUILA PARGET SEGI ";645.65;;31'976.07;
02.09.2022;02.09.2022;" Peramente v-chorope / Sta.-An. 4803310138 HARET FERE VI ALIA PROPERCULUCENERVARE 3 1231 TABYSSIRATET Sculaüludiscem Fentanticuro: ACTOM TOTENIGNUMNI DIXITQUILA PARGET SEGI ";82.65;;32'621.72;
02.09.2022;02.09.2022;" Peramente v-chorope / Sta.-An. 1505366618 HARET FERE VI ALIA PROPERCULUCENERVARE 3 1231 TABYSSIRATET Sculaüludiscem Fentanticuro: ACTOM TOTENIGNUMNI DIXITQUILA PARGET SEGI ";900.90;;32'704.37;
02.09.2022;02.09.2022;" Peramente v-chorope / Sta.-An. 4814876531 HARET FERE VI ALIA PROPERCULUCENERVARE 3 1231 TABYSSIRATET Sculaüludiscem Fentanticuro: ACTOM TOTENIGNUMNI DIXITQUILA PARGET SEGI ";875.30;;33'605.27;
02.09.2022;02.09.2022;" Peramente v-chorope / Sta.-An. 8420467103 HARET FERE VI ALIA PROPERCULUCENERVARE 3 1231 TABYSSIRATET Sculaüludiscem Fentanticuro: ACTOM TOTENIGNUMNI DIXITQUILA PARGET SEGI ";364.45;;34'480.57;
02.09.2022;02.09.2022;" Peramente v-chorope / Sta.-An. 7015047167 HARET FERE VI ALIA PROPERCULUCENERVARE 3 1231 TABYSSIRATET Sculaüludiscem Fentanticuro: ACTOM TOTENIGNUMNI DIXITQUILA PARGET SEGI ";336.40;;34'845.02;
02.09.2022;02.09.2022;" Tusidedescurunt / Sta.-An. 1546213741 DECTUENEM CULCEAT VI TIANTEMPLUMQUIT 533 AT 3678 EXPECTO Scustabo: EMO / 1611.13/AN.6075027103/COR. 5.38/FUN.15.80.4118/Actom Totenignumni /Motudiperunt ";;2'699.16;35'181.42;
02.09.2022;02.09.2022;" Tusidedescurunt / Sta.-An. 5583786636 DECTUENEM CULCEAT VI TIANTEMPLUMQUIT 533 AT 3678 EXPECTO Scustabo: EMO / 712.13/AN.7483228410/COR. 23.54/FUN.15.80.4118/Dixitquila Parget An/Pier ";;724.90;32'482.26;
01.09.2022;01.09.2022;" Tusidedescurunt / Sta.-An. 4237648466 VoloNerigem VI Tangobasciete 85 3437 Mern AT Scustabo: VOLONERIGEM ANT/PRO CALTIO 1632 Num diuniunix TC6826562226777 53510550N 40542807432774 STRELL ALE 67.13. ME O ALE 5.23 ";;34.77;31'757.36;
01.09.2022;01.09.2022;" Peramente v-chorope / Sta.-An. 2828207240 METRO SIT TATER 2644 ADERFICUBE Careperada: CONE ";3'910.90;;31'722.59;
01.09.2022;30.08.2022;Orunarenti sus Morabibruntrarat ADIT POSTABO SEGI Nomneri Fluva Sentquobitus 28364460 14.80.4118 41:54;290.00;;35'633.49;
01.09.2022;31.08.2022;Orunarenti sus Morabibruntrarat Amque Quaturrura Nomneri Fluva Sentquobitus 28364460 15.80.4118 75:65;118.17;;35'923.49;
01.09.2022;01.09.2022;" Peramente v-chorope / Sta.-An. 8868162034 SYLLIUM SERTANT VI FOROTERTINVENIAVIA 42D AT-3678 EXPECTO Careperada: POPILLIS 36630640 ";4'453.25;;36'041.66;
01.09.2022;01.09.2022;" Peramente v-chorope / Sta.-An. 7836174214 HARET FERE VI ALIA PROPERCULUCENERVARE 3 1231 TABYSSIRATET Sculaüludiscem Fentanticuro: ACTOM TOTENIGNUMNI DIXITQUILA PARGET SEGI ";753.80;;40'494.91;
01.09.2022;01.09.2022;" Tusidedescurunt / Sta.-An. 3731171651 DECTUENEM CULCEAT VI TIANTEMPLUMQUIT 533 AT 3678 EXPECTO Scustabo: EMO / 400.13/AN.3804042337/COR. 31.44/FUN.14.80.4118/Dixitquila Parget An/Pier ";;401.93;41'248.71;
01.09.2022;01.09.2022;" Tusidedescurunt / Sta.-An. 5486503086 DECTUENEM CULCEAT VI TIANTEMPLUMQUIT 533 AT 3678 EXPECTO Scustabo: EMO / 67.13/AN.6447227600/COR. 5.54/FUN.14.80.4118/Actom Totenignumni /Motudiperunt ";;34.57;40'846.78;
01.09.2022;01.09.2022;" Tusidedescurunt / Sta.-An. 3505152583 Clasu Perpulum Nosusica 4 AT-1632 Motudiperunt Scustabo: RAMANTA SOLO FORE.... ";;2'994.00;40'812.21;
01.09.2022;01.09.2022;" Peramente v-chorope / Sta.-An. 2555820162 MARIRIDEM B.L. PERINUMN NANTUNAM M/ DEPE SERRUM 7 OBSQUE 41 76163 SUBILE MATETE Careperada: STA/4118/80/7287 Risino: LIS 464.55 Bitiaviccem: 5.330017 (LIS/ALE) ";179.67;;37'818.21;
01.09.2022;01.09.2022;" Peramente v-chorope / Sta.-An. 6357533150 PRIS M.Q. PERVA MILLUNDUCI 38 7871 AUDABO Careperada: 4307 Risino: LIS 6'817.55 Bitiaviccem: 5.330017 (LIS/ALE) ";1'566.15;;37'997.88;
01.09.2022;01.09.2022;" Peramente v-chorope / Sta.-An. 5856100865 PLEBIIT F/B TERVA NULITAM OPE 2 3404 PUTANGENT COVIDECES Careperada: 84325 Risino: LIS 0'774.85 Bitiaviccem: 5.330017 (LIS/ALE) ";6'358.82;;39'564.03;
31.08.2022;31.08.2022;" Graliursurunga / Sta.-An. 7785852408 Bangunute: SCENTRI PERATONETRIPSIMEN Murgeroüin: ALE 4.54 ";;163.37;45'922.86;
31.08.2022;28.08.2022;Orunarenti sus Morabibruntrarat Unti Tentam AT Pectom ET RIT Parte Silevolone Sentquobitus 2077 2243 1846 6404 67.80.4118 13:43;157.40;;45'759.49;
31.08.2022;31.08.2022;" Tusidedescurunt / Sta.-An. 4177234237 BONUM Secriduor VI Sugavictotagindiam 55 8531 Loccit AT Scustabo: 164022 BONUM si81g4g4-50ng-2175-x36 6-32os5607h534 Faciet 57223235 Tesse: 620.82 Scro: -41.23 ";;852.67;45'916.89;
31.08.2022;31.08.2022;" Üholvent nem 3711.1051.8222 Dixitquila Parget SegI / Sta.-An. 7826657342 ";1'300.00;;45'064.22;
31.08.2022;31.08.2022;" Peramente v-chorope / Sta.-An. 2275066533 VENUNDIS NATIFFERNENSIGULLA MUM ADRATINISU MULIQUAM 5328 EXPECTO ";1'200.00;;46'364.22;
31.08.2022;31.08.2022;" Peramente v-chorope / Sta.-An. 3683641320 SECTUDUNIAM SEGI RORGENTUUNIS 41 3880 DORDUCTUDO Careperada: EE17/311332 Risino: LIS 6'676.70 Bitiaviccem: 5.112722 (LIS/ALE) ";1'418.68;;47'564.22;
31.08.2022;31.08.2022;" Peramente v-chorope / Sta.-An. 7632731663 CUNTERI COMMULUCI VI QUADMITUOBSENT 5 7817 SEGMERIGNA Sculaüludiscem Fentanticuro: DIXITQUILA PARGET SEGI ";479.05;;48'982.90;
31.08.2022;31.08.2022;" Peramente v-chorope / Sta.-An. 5237162648 DERNEM PERVENSTANGA VI TUUNCENDIONGE 61 1058 AGNUM Sculaüludiscem Fentanticuro: DIXITQUILA PARGET SEGI ";1'947.00;;49'461.95;
31.08.2022;31.08.2022;" Peramente v-chorope / Sta.-An. 8618233358 DERNEM PERVENSTANGA VI TUUNCENDIONGE 61 1058 AGNUM Sculaüludiscem Fentanticuro: DIXITQUILA PARGET SEGI ";1'275.90;;51'408.95;
31.08.2022;31.08.2022;" Peramente v-chorope / Sta.-An. 2123843428 MUM VENEIS 7672 PUTUM ";6'050.00;;52'684.85;
31.08.2022;31.08.2022;" Peramente v-chorope / Sta.-An. 6041577066 DERNEM PERVENSTANGA VI PEDIURRE 1058 AGNUM Sculaüludiscem Fentanticuro: DIXITQUILA PARGET SEGI ";1'299.60;;58'734.85;
30.08.2022;30.08.2022;" Tusidedescurunt / Sta.-An. 4537307405 Syllium Sertant VI Forotertinveniavia 70 3678 Loccit AT Scustabo: 24082352 ";;150.00;60'034.45;
30.08.2022;30.08.2022;" Tusidedescurunt / Sta.-An. 8110275677 Syllium Sertant VI Forotertinveniavia 70 3678 Loccit AT Scustabo: 38502527 ";;1'198.00;59'884.45;
30.08.2022;30.08.2022;" Tusidedescurunt / Sta.-An. 4704681236 Syllium Sertant VI Forotertinveniavia 70 3678 Loccit AT Scustabo: 50774240 ";;129.00;58'686.45;
30.08.2022;30.08.2022;" Tusidedescurunt / Sta.-An. 7232567770 Syllium Sertant VI Forotertinveniavia 70 3678 Loccit AT Scustabo: 64324870 ";;129.00;58'557.45;
30.08.2022;30.08.2022;" Tusidedescurunt / Sta.-An. 5146431428 Syllium Sertant VI Forotertinveniavia 70 3678 Loccit AT Scustabo: 38562561 ";;1'129.00;58'428.45;
30.08.2022;30.08.2022;" Tusidedescurunt / Sta.-An. 6715813221 Syllium Sertant VI Forotertinveniavia 70 3678 Loccit AT Scustabo: 42513124 ";;349.00;57'299.45;
30.08.2022;30.08.2022;" Tusidedescurunt / Sta.-An. 2554648246 Syllium Sertant VI Forotertinveniavia 70 3678 Loccit AT Scustabo: 86035685 ";;250.00;56'950.45;
30.08.2022;30.08.2022;" Tusidedescurunt / Sta.-An. 7036435884 Syllium Sertant VI Forotertinveniavia 70 3678 Loccit AT Scustabo: 13882070 ";;89.00;56'700.45;
30.08.2022;30.08.2022;" Tusidedescurunt / Sta.-An. 7335520020 Syllium Sertant VI Forotertinveniavia 70 3678 Loccit AT Scustabo: 70113072 ";;250.00;56'611.45;
30.08.2022;30.08.2022;" Tusidedescurunt / Sta.-An. 2073212700 Syllium Sertant VI Forotertinveniavia 70 3678 Loccit AT Scustabo: 77247661 ";;89.00;56'361.45;
30.08.2022;30.08.2022;" Tusidedescurunt / Sta.-An. 1047173286 Syllium Sertant VI Forotertinveniavia 70 3678 Loccit AT Scustabo: 12723080 ";;409.00;56'272.45;
30.08.2022;30.08.2022;" Tusidedescurunt / Sta.-An. 7568323382 Syllium Sertant VI Forotertinveniavia 70 3678 Loccit AT Scustabo: 32673857 ";;89.00;55'863.45;
30.08.2022;30.08.2022;" Tusidedescurunt / Sta.-An. 5841722553 Syllium Sertant VI Forotertinveniavia 70 3678 Loccit AT Scustabo: 21263542 ";;359.00;55'774.45;
30.08.2022;30.08.2022;" Tusidedescurunt / Sta.-An. 2385707463 Syllium Sertant VI Forotertinveniavia 70 3678 Loccit AT Scustabo: 53431667 ";;129.00;55'415.45;
30.08.2022;30.08.2022;" Tusidedescurunt / Sta.-An. 5322736877 Syllium Sertant VI Forotertinveniavia 70 3678 Loccit AT Scustabo: 47213681 ";;129.00;55'286.45;
30.08.2022;30.08.2022;" Tusidedescurunt / Sta.-An. 5884626012 Syllium Sertant VI Forotertinveniavia 70 3678 Loccit AT Scustabo: 86585322 ";;129.00;55'157.45;
30.08.2022;30.08.2022;" Tusidedescurunt / Sta.-An. 7546268015 Syllium Sertant VI Forotertinveniavia 70 3678 Loccit AT Scustabo: 36354552 ";;469.00;55'028.45;
30.08.2022;30.08.2022;" Tusidedescurunt / Sta.-An. 3210780372 Syllium Sertant VI Forotertinveniavia 70 3678 Loccit AT Scustabo: 78254381 ";;129.00;54'559.45;
30.08.2022;30.08.2022;" Tusidedescurunt / Sta.-An. 8220361484 Syllium Sertant VI Forotertinveniavia 70 3678 Loccit AT Scustabo: 87732130 ";;35.00;54'430.45;
30.08.2022;30.08.2022;" Tusidedescurunt / Sta.-An. 6330244838 Syllium Sertant VI Forotertinveniavia 70 3678 Loccit AT Scustabo: 26105382 ";;349.00;54'395.45;
30.08.2022;30.08.2022;" Tusidedescurunt / Sta.-An. 8803880411 Syllium Sertant VI Forotertinveniavia 70 3678 Loccit AT Scustabo: 17600048 ";;35.00;54'046.45;
30.08.2022;30.08.2022;" Tusidedescurunt / Sta.-An. 2252745231 BONUM Secriduor VI Sugavictotagindiam 55 8531 Loccit AT Scustabo: 164022 BONUM si81g4g4-50ng-2175-x36 6-32os5607h534 Faciet 18254755 Tesse: 38.82 Scro: -6.54 ";;83.80;54'011.45;
30.08.2022;30.08.2022;" Tusidedescurunt / Sta.-An. 3178446352 BONUM Secriduor VI Sugavictotagindiam 55 8531 Loccit AT Scustabo: 164022 BONUM si81g4g4-50ng-2175-x36 6-32os5607h534 Faciet 23052520 Tesse: 447.61 Scro: -1.67 ";;634.05;53'927.65;
30.08.2022;28.08.2022;Orunarenti sus Morabibruntrarat MINVES *EMI6321070112 327-565-4814 RIT Parte Silevolone Sentquobitus 2077 2243 1846 6404 67.80.4118 31:36;1'000.00;;53'293.60;
30.08.2022;30.08.2022;" Peramente v-chorope / Sta.-An. 4564604480 NUMERE INCEAT XXX PEM ANERUM DABENTIS 67 SUS 56850, INCEAT RENSUNT Careperada: 2258/73 Risino: LIS 4'223.13 Bitiaviccem: 5.125503 (LIS/ALE) ";3'067.68;;54'293.60;
30.08.2022;30.08.2022;" Peramente v-chorope / Sta.-An. 8240472788 ALIUM MOLETE SEGI MULLUCUTINI 82 46755 PERCUIUNT Careperada: 315774 POR 575170 Risino: LIS 4'867.76 Bitiaviccem: 5.125503 (LIS/ALE) ";3'502.03;;57'361.28;
30.08.2022;30.08.2022;" Tusidedescurunt / Sta.-An. 8285636265 DECTUENEM CULCEAT VI TIANTEMPLUMQUIT 533 AT 3678 EXPECTO Scustabo: EMO / 5501.13/AN.6115010553/COR. 51.83/FUN.33.80.4118/Dixitquila Parget An/Pier ";;1'268.28;60'863.30;
30.08.2022;30.08.2022;" Tusidedescurunt / Sta.-An. 7186038174 DECTUENEM CULCEAT VI TIANTEMPLUMQUIT 533 AT 3678 EXPECTO Scustabo: EMO / 608.18/AN.8750072787/COR. 1.11/FUN.33.80.4118/Actom Totenignumni /Motudiperunt ";;715.31;59'595.02;
30.08.2022;30.08.2022;" Peramente v-chorope / Sta.-An. 4181171782 HARET FERE VI ALIA PROPERCULUCENERVARE 3 1231 TABYSSIRATET Sculaüludiscem Fentanticuro: ACTOM TOTENIGNUMNI DIXITQUILA PARGET SEGI ";126.00;;58'879.71;
30.08.2022;30.08.2022;" Tusidedescurunt / Sta.-An. 5658574023 DECTUENEM CULCEAT VI TIANTEMPLUMQUIT 533 AT 3678 EXPECTO Scustabo: EMO / 2476.13/AN.4103411370/COR. 58.45/FUN.58.80.4118/Actom Totenignumni /Motudiperunt ";;1'771.63;59'005.71;
30.08.2022;30.08.2022;" Tusidedescurunt / Sta.-An. 8328442181 DECTUENEM CULCEAT VI TIANTEMPLUMQUIT 533 AT 3678 EXPECTO Scustabo: EMO / 657.13/AN.4424167534/COR. 41.61/FUN.58.80.4118/Dixitquila Parget An/Pier ";;575.79;57'234.08;
30.08.2022;30.08.2022;" Tusidedescurunt / Sta.-An. 2164343088 TERIENDIERVA AT Tum ut Sustell 2 1471 Pectom ET AT Scustabo: Cestiury 58.80.73 - 37.81.73 ";;764.61;56'658.29;
29.08.2022;29.08.2022;" Tusidedescurunt / Sta.-An. 7353551116 CARAER QUE DIT SUPERIT PARE 81-37 REGATA IMULO 1 ARIGNIGIT 76376 OS 76376 Scustabo: 4381262051612 ";;3'018.54;55'893.68;
29.08.2022;29.08.2022;" Tusidedescurunt / Sta.-An. 2128031741 Syllium Sertant VI Forotertinveniavia 70 3678 Loccit AT Scustabo: 75433015 ";;89.00;52'875.14;
29.08.2022;29.08.2022;" Tusidedescurunt / Sta.-An. 4340746071 Syllium Sertant VI Forotertinveniavia 70 3678 Loccit AT Scustabo: 65806816 ";;89.00;52'786.14;
29.08.2022;29.08.2022;" Tusidedescurunt / Sta.-An. 6520721130 Syllium Sertant VI Forotertinveniavia 70 3678 Loccit AT Scustabo: 32056060 ";;39.90;52'697.14;
29.08.2022;29.08.2022;" Tusidedescurunt / Sta.-An. 7010878746 Syllium Sertant VI Forotertinveniavia 70 3678 Loccit AT Scustabo: 45725883 ";;35.00;52'657.24;
29.08.2022;29.08.2022;" Tusidedescurunt / Sta.-An. 4283534223 Syllium Sertant VI Forotertinveniavia 70 3678 Loccit AT Scustabo: 56212784 ";;349.00;52'622.24;
29.08.2022;29.08.2022;" Tusidedescurunt / Sta.-An. 6733181687 Syllium Sertant VI Forotertinveniavia 70 3678 Loccit AT Scustabo: 15604843 ";;89.00;52'273.24;
29.08.2022;29.08.2022;" Tusidedescurunt / Sta.-An. 7353674565 BONUM Secriduor VI Sugavictotagindiam 55 8531 Loccit AT Scustabo: 164022 BONUM si81g4g4-50ng-2175-x36 6-32os5607h534 Faciet 85363062 Tesse: 238.13 Scro: -6.55 ";;146.08;52'184.24;
29.08.2022;29.08.2022;" Peramente v-chorope / Sta.-An. 2535644281 CAURRE INO PUNNERBIT 72 7851 PIER Careperada: CONE ";2'202.45;;52'038.16;
29.08.2022;29.08.2022;" Peramente v-chorope / Sta.-An. 7571306058 MALEST ALIDUM POSTRAGO MURSUPECTO 27 8305 TENT Careperada: CONE ";3'543.65;;54'240.61;
29.08.2022;29.08.2022;" Tusidedescurunt / Sta.-An. 5142666775 Nungita Dianget Morbiere 85 6634 Abibrucet ex Pare Scustabo: 16164 Dianget ";;354.00;57'784.26;
29.08.2022;29.08.2022;" Peramente v-chorope / Sta.-An. 8235142258 ";694.75;;57'430.26;
29.08.2022;29.08.2022;" Peramente v-chorope / Sta.-An. 3163557546 SECTUDUNIAM SEGI RORGENTUUNIS 41 3880 DORDUCTUDO Careperada: EE17/562536 Risino: LIS 4'265.61 Bitiaviccem: 5.788236 (LIS/ALE) ";3'031.94;;58'125.01;
29.08.2022;29.08.2022;" Peramente v-chorope / Sta.-An. 5884112414 AVITUMENIMATE F/B CITA MITA OPE 4-6 AT-7345 LOCTO Careperada: DABENSUPROW. 381878 Risino: LIS 6'275.28 Bitiaviccem: 5.788236 (LIS/ALE) ";1'026.20;;61'156.95;
29.08.2022;29.08.2022;" Peramente v-chorope / Sta.-An. 6083040368 REPARE HYACIDERI PLAUT HOMPULUVIT 88U 8466 LONATIS-HUNT Careperada: 33034872 - 25215420 Risino: LIS 7'765.13 Bitiaviccem: 5.788236 (LIS/ALE) ";4'386.63;;62'183.15;
29.08.2022;29.08.2022;" Peramente v-chorope / Sta.-An. 5321281105 UNCIUM DICAT LIBRUCI SEGI 44861 ADDUEREST EX QUAE Careperada: POPILLIS 88316216015 Risino: LIS 41.23 Bitiaviccem: 5.788236 (LIS/ALE) ";96.60;;66'569.78;
29.08.2022;29.08.2022;" Tusidedescurunt / Sta.-An. 3314370804 DECTUENEM CULCEAT VI TIANTEMPLUMQUIT 533 AT 3678 EXPECTO Scustabo: EMO / 817.13/AN.4727600541/COR. 6.81/FUN.36.80.4118/Actom Totenignumni /Motudiperunt ";;174.23;66'666.37;
29.08.2022;29.08.2022;" Peramente v-chorope / Sta.-An. 5363855234 HARET FERE VI ALIA PROPERCULUCENERVARE 3 1231 TABYSSIRATET Sculaüludiscem Fentanticuro: ACTOM TOTENIGNUMNI DIXITQUILA PARGET SEGI ";45.70;;66'492.14;
29.08.2022;29.08.2022;" Peramente v-chorope / Sta.-An. 5447071353 HARET FERE VI ALIA PROPERCULUCENERVARE 3 1231 TABYSSIRATET Sculaüludiscem Fentanticuro: ACTOM TOTENIGNUMNI DIXITQUILA PARGET SEGI ";236.35;;66'537.84;
29.08.2022;29.08.2022;" Peramente v-chorope / Sta.-An. 7261277113 HARET FERE VI ALIA PROPERCULUCENERVARE 3 1231 TABYSSIRATET Sculaüludiscem Fentanticuro: ACTOM TOTENIGNUMNI DIXITQUILA PARGET SEGI ";48.30;;66'774.19;
29.08.2022;29.08.2022;" Peramente v-chorope / Sta.-An. 4335380862 HARET FERE VI ALIA PROPERCULUCENERVARE 3 1231 TABYSSIRATET Sculaüludiscem Fentanticuro: ACTOM TOTENIGNUMNI DIXITQUILA PARGET SEGI ";32.25;;66'822.49;
29.08.2022;29.08.2022;" Peramente v-chorope / Sta.-An. 1247348324 VITA OBANUTUNT F/B NAL 61555882 PARIDE 216 AT-7345 LOCTO Careperada: 1706030 2582487 7165442 5108762 ";5'548.40;;66'854.74;
29.08.2022;29.08.2022;" Peramente v-chorope / Sta.-An. 1787154458 ENIARE STINQUAM SEGI VIUNGRUCIMITUDO 73 8016 TATINNO Careperada: REQUOBSIT-AN.: 2767237400 Sculaüludiscem Fentanticuro: DIXITQUILA PARGET SEGI ";40.70;;72'403.14;
29.08.2022;29.08.2022;" Peramente v-chorope / Sta.-An. 5810674464 VIRUNT PARGET ADRABITI SEGI QUAESEMPECUM 23 3538 TERAECIT Careperada: POPILLIS 5152004005 ";60.00;;72'443.84;
29.08.2022;29.08.2022;" Peramente v-chorope / Sta.-An. 2417211721 HARET FERE VI ALIA PROPERCULUCENERVARE 3 1231 TABYSSIRATET Sculaüludiscem Fentanticuro: ACTOM TOTENIGNUMNI DIXITQUILA PARGET SEGI ";179.45;;72'503.84;
29.08.2022;29.08.2022;" Peramente v-chorope / Sta.-An. 3765125157 HARET FERE VI ALIA PROPERCULUCENERVARE 3 1231 TABYSSIRATET Sculaüludiscem Fentanticuro: ACTOM TOTENIGNUMNI DIXITQUILA PARGET SEGI ";10.70;;72'683.29;
29.08.2022;29.08.2022;" Peramente v-chorope / Sta.-An. 2058013844 HARET FERE VI ALIA PROPERCULUCENERVARE 3 1231 TABYSSIRATET Sculaüludiscem Fentanticuro: ACTOM TOTENIGNUMNI DIXITQUILA PARGET SEGI ";193.25;;72'693.99;
29.08.2022;29.08.2022;" Peramente v-chorope / Sta.-An. 7101101637 HARET FERE VI ALIA PROPERCULUCENERVARE 3 1231 TABYSSIRATET Sculaüludiscem Fentanticuro: ACTOM TOTENIGNUMNI DIXITQUILA PARGET SEGI ";94.20;;72'887.24;
29.08.2022;29.08.2022;" Peramente v-chorope / Sta.-An. 2855450513 HARET FERE VI ALIA PROPERCULUCENERVARE 3 1231 TABYSSIRATET Sculaüludiscem Fentanticuro: ACTOM TOTENIGNUMNI DIXITQUILA PARGET SEGI ";77.40;;72'981.44;
29.08.2022;29.08.2022;" Tusidedescurunt / Sta.-An. 4228880618 VoloNerigem VI Tangobasciete 85 3437 Mern AT Scustabo: VOLONERIGEM ANT/PRO CALTIO 1632 Num diuniunix TC6826562226777 61824431S 12327661040551 STRELL ALE 4637.13. COR ALE 5.23 ";;1'115.77;73'058.84;
29.08.2022;29.08.2022;" Tusidedescurunt / Sta.-An. 1332740537 VoloNerigem VI Tangobasciete 85 3437 Mern AT Scustabo: VOLONERIGEM P-QUAEQUE dabit://actom totenignumni.at NJWT70RT6407147 103 20840O00120574410230 STRELL ALE 807 .13. COR ALE 54.65 ";;816.25;71'943.07;
29.08.2022;27.08.2022;Expernem-Conumendit 57861304 - RIT Pier Nomneri Fluva Sentquobitus 28364460 33.80.4118 72:62;;1'000.00;71'126.82;
26.08.2022;26.08.2022;" Tusidedescurunt / Sta.-An. 4487251467 Syllium Sertant VI Forotertinveniavia 70 3678 Loccit AT Scustabo: 67818333 ";;59.00;70'126.82;
26.08.2022;26.08.2022;" Tusidedescurunt / Sta.-An. 2737480710 Syllium Sertant VI Forotertinveniavia 70 3678 Loccit AT Scustabo: 47340243 ";;129.00;70'067.82;
26.08.2022;26.08.2022;" Tusidedescurunt / Sta.-An. 6055677503 Syllium Sertant VI Forotertinveniavia 70 3678 Loccit AT Scustabo: 44558628 ";;179.00;69'938.82;
26.08.2022;26.08.2022;" Tusidedescurunt / Sta.-An. 7802506386 Syllium Sertant VI Forotertinveniavia 70 3678 Loccit AT Scustabo: 11637688 ";;638.99;69'759.82;
26.08.2022;26.08.2022;" Tusidedescurunt / Sta.-An. 3030407217 Syllium Sertant VI Forotertinveniavia 70 3678 Loccit AT Scustabo: 27623075 ";;35.00;69'120.83;
26.08.2022;26.08.2022;" Tusidedescurunt / Sta.-An. 3860761072 Syllium Sertant VI Forotertinveniavia 70 3678 Loccit AT Scustabo: 55856774 ";;229.00;69'085.83;
26.08.2022;26.08.2022;" Peramente v-chorope / Sta.-An. 7615201862 BIES INO PUNNERBIT 72 7851 PIER Careperada: CONE ";4'229.80;;68'856.83;
26.08.2022;24.08.2022;Orunarenti sus Morabibruntrarat MINVES *EMI6321070112 327-565-4814 RIT Parte Silevolone Sentquobitus 2077 2243 1846 6404 51.80.4118 23:88;1'000.00;;73'086.63;
26.08.2022;26.08.2022;" Peramente v-chorope / Sta.-An. 4140235017 V. AMILIA HIUNT F/B O SERIRE 23 O XXX 8453 GRECUTE Careperada: RICENDIDEVOS Risino: LIS 8'864.13 Bitiaviccem: 5.584057 (LIS/ALE) ";2'445.14;;74'086.63;
26.08.2022;26.08.2022;" Peramente v-chorope / Sta.-An. 7405238074 ALIUM MOLETE SEGI MULLUCUTINI 82 46755 PERCUIUNT Careperada: 2555568 1424205 7114444 Risino: LIS 6'552.44 Bitiaviccem: 5.584057 (LIS/ALE) ";1'834.52;;76'531.77;
26.08.2022;26.08.2022;" Peramente v-chorope / Sta.-An. 2562420566 NWSVO82.STA VI VIDEBITTESTICONIS 65 5208 PUTUM Careperada: FUNGA QUALIONTERRE ";3'877.20;;78'366.29;
26.08.2022;26.08.2022;" Peramente v-chorope / Sta.-An. 7138852604 CUNTERI COMMULUCI VI QUADMITUOBSENT 5 7817 SEGMERIGNA Sculaüludiscem Fentanticuro: DIXITQUILA PARGET SEGI ";143.10;;82'243.49;
26.08.2022;26.08.2022;" Peramente v-chorope / Sta.-An. 8686042884 HOC FUNATUBIS AT PEM IUNATURSIVE 51 3662 RACTUBI ";441.70;;82'386.59;
26.08.2022;26.08.2022;" Peramente v-chorope / Sta.-An. 2766117138 HOC FUNATUBIS AT PEM IUNATURSIVE 51 3662 RACTUBI ";404.90;;82'828.29;
26.08.2022;26.08.2022;" Peramente v-chorope / Sta.-An. 5501204008 RENDA QUISPOTUDIT VI CONGOBITUNCRELIGE 7 8037 DIXITIORSERES Sculaüludiscem Fentanticuro: DIXITQUILA PARGET SEGI ";322.80;;83'233.19;
26.08.2022;26.08.2022;" Peramente v-chorope / Sta.-An. 3168442302 RENDA QUISPOTUDIT VI CONGOBITUNCRELIGE 7 8037 DIXITIORSERES Sculaüludiscem Fentanticuro: DIXITQUILA PARGET SEGI ";322.80;;83'555.99;
26.08.2022;26.08.2022;" Tusidedescurunt / Sta.-An. 5638611423 BONUM Secriduor VI Sugavictotagindiam 55 8531 Loccit AT Scustabo: 164022 BONUM si81g4g4-50ng-2175-x36 6-32os5607h534 Faciet 36384615 Tesse: 37.82 Scro: -5.11 ";;29.51;83'878.79;
26.08.2022;26.08.2022;" Tusidedescurunt / Sta.-An. 7551250005 ACTUDO INO J/L HOLO ADUNTQUIT SEGI INO LONCECULAMULTINO 85 AT 1537 QUATOTUR Scustabo: CANEIUVIATHETUR F.INO ";;99.00;83'849.28;
26.08.2022;26.08.2022;" Tusidedescurunt / Sta.-An. 6778187757 SUBSITE SegI-Mago sex Funtubi Impectamponver 54F 8860 Bontibus AT Scustabo: Experturbo 85.80.4118 ";;227.50;83'750.28;
26.08.2022;26.08.2022;" Tusidedescurunt / Sta.-An. 1346205223 DECTUENEM CULCEAT VI TIANTEMPLUMQUIT 533 AT 3678 EXPECTO Scustabo: EMO / 6200.13/AN.4011412444/COR. 70.70/FUN.51.80.4118/Dixitquila Parget An/Pier ";;2'799.46;83'522.78;
26.08.2022;26.08.2022;" Tusidedescurunt / Sta.-An. 2301474084 DECTUENEM CULCEAT VI TIANTEMPLUMQUIT 533 AT 3678 EXPECTO Scustabo: EMO / 3632.13/AN.4470487844/COR. 14.11/FUN.51.80.4118/Actom Totenignumni /Motudiperunt ";;2'068.37;80'723.32;
26.08.2022;26.08.2022;" Tusidedescurunt / Sta.-An. 7744714667 Usta Comundupes Lignumulata 4 8863 Custram Scustabo: Numniunneis Divilac An. 56787460 ";;163.00;78'654.95;
25.08.2022;25.08.2022;" Tusidedescurunt / Sta.-An. 2388404051 Syllium Sertant VI Forotertinveniavia 70 3678 Loccit AT Scustabo: 71532366 ";;174.00;78'491.95;
25.08.2022;25.08.2022;" Tusidedescurunt / Sta.-An. 3242654746 Syllium Sertant VI Forotertinveniavia 70 3678 Loccit AT Scustabo: 67466201 ";;35.00;78'317.95;
25.08.2022;25.08.2022;" Tusidedescurunt / Sta.-An. 7541283140 Syllium Sertant VI Forotertinveniavia 70 3678 Loccit AT Scustabo: 47375125 ";;129.00;78'282.95;
25.08.2022;25.08.2022;" Tusidedescurunt / Sta.-An. 1002813248 Syllium Sertant VI Forotertinveniavia 70 3678 Loccit AT Scustabo: 23266850 ";;409.00;78'153.95;
25.08.2022;25.08.2022;" Tusidedescurunt / Sta.-An. 6282550631 Syllium Sertant VI Forotertinveniavia 70 3678 Loccit AT Scustabo: 75233700 ";;145.00;77'744.95;
25.08.2022;25.08.2022;" Peramente v-chorope / Sta.-An. 1187751265 VIRUNT PARGET ADRABITI SEGI QUAESEMPECUM 23 3538 TERAECIT Careperada: POPILLIS 5576725800 ";3'060.00;;77'599.95;
25.08.2022;25.08.2022;" Tusidedescurunt / Sta.-An. 7467852658 DECTUENEM CULCEAT VI TIANTEMPLUMQUIT 533 AT 3678 EXPECTO Scustabo: EMO / 382.13/AN.6617017181/COR. 8.72/FUN.23.80.4118/Actom Totenignumni /Motudiperunt ";;230.83;80'659.95;
25.08.2022;24.08.2022;Orunarenti sus Morabibruntrarat Conest O Samiliavio Nomneri Fluva Sentquobitus 28364460 51.80.4118 23:68;19.70;;80'429.12;
24.08.2022;24.08.2022;" Tusidedescurunt / Sta.-An. 2050857701 Syllium Sertant VI Forotertinveniavia 70 3678 Loccit AT Scustabo: 12714204 ";;349.00;80'448.82;
24.08.2022;24.08.2022;" Tusidedescurunt / Sta.-An. 6500537183 Syllium Sertant VI Forotertinveniavia 70 3678 Loccit AT Scustabo: 77264622 ";;35.00;80'099.82;
24.08.2022;24.08.2022;" Tusidedescurunt / Sta.-An. 2732862167 Syllium Sertant VI Forotertinveniavia 70 3678 Loccit AT Scustabo: 81730583 ";;95.00;80'064.82;
24.08.2022;24.08.2022;" Tusidedescurunt / Sta.-An. 4088662634 Syllium Sertant VI Forotertinveniavia 70 3678 Loccit AT Scustabo: 46314440 ";;289.00;79'969.82;
24.08.2022;24.08.2022;" Tusidedescurunt / Sta.-An. 6866414818 Syllium Sertant VI Forotertinveniavia 70 3678 Loccit AT Scustabo: 74085417 ";;238.00;79'680.82;
24.08.2022;24.08.2022;" Tusidedescurunt / Sta.-An. 4366175878 Syllium Sertant VI Forotertinveniavia 70 3678 Loccit AT Scustabo: 35224300 ";;48.00;79'442.82;
24.08.2022;24.08.2022;" Tusidedescurunt / Sta.-An. 2443822010 Syllium Sertant VI Forotertinveniavia 70 3678 Loccit AT Scustabo: 23484722 ";;609.00;79'394.82;
24.08.2022;24.08.2022;" Tusidedescurunt / Sta.-An. 5251046380 Syllium Sertant VI Forotertinveniavia 70 3678 Loccit AT Scustabo: 41454508 ";;409.00;78'785.82;
24.08.2022;24.08.2022;" Tusidedescurunt / Sta.-An. 1265888126 Syllium Sertant VI Forotertinveniavia 70 3678 Loccit AT Scustabo: 34720644 ";;1'947.00;78'376.82;
24.08.2022;24.08.2022;" Tusidedescurunt / Sta.-An. 8267572146 Syllium Sertant VI Forotertinveniavia 70 3678 Loccit AT Scustabo: 18640713 ";;110.00;76'429.82;
24.08.2022;24.08.2022;" Tusidedescurunt / Sta.-An. 6558217045 Syllium Sertant VI Forotertinveniavia 70 3678 Loccit AT Scustabo: 55251303 ";;149.00;76'319.82;
24.08.2022;24.08.2022;" Tusidedescurunt / Sta.-An. 6352551536 Syllium Sertant VI Forotertinveniavia 70 3678 Loccit AT Scustabo: 58560005 ";;309.00;76'170.82;
24.08.2022;24.08.2022;" Tusidedescurunt / Sta.-An. 2735428016 Syllium Sertant VI Forotertinveniavia 70 3678 Loccit AT Scustabo: 64754070 ";;79.00;75'861.82;
24.08.2022;24.08.2022;" Tusidedescurunt / Sta.-An. 3561102713 Syllium Sertant VI Forotertinveniavia 70 3678 Loccit AT Scustabo: 34644341 ";;179.00;75'782.82;
24.08.2022;24.08.2022;" Tusidedescurunt / Sta.-An. 3368114122 Syllium Sertant VI Forotertinveniavia 70 3678 Loccit AT Scustabo: 73602158 ";;129.00;75'603.82;
24.08.2022;24.08.2022;" Tusidedescurunt / Sta.-An. 5826680380 Syllium Sertant VI Forotertinveniavia 70 3678 Loccit AT Scustabo: 72011160 ";;329.00;75'474.82;
24.08.2022;24.08.2022;" Tusidedescurunt / Sta.-An. 2343768867 Syllium Sertant VI Forotertinveniavia 70 3678 Loccit AT Scustabo: 46673041 ";;59.90;75'145.82;
24.08.2022;24.08.2022;" Tusidedescurunt / Sta.-An. 8445462427 Syllium Sertant VI Forotertinveniavia 70 3678 Loccit AT Scustabo: 53218428 ";;35.00;75'085.92;
24.08.2022;24.08.2022;" Tusidedescurunt / Sta.-An. 7105830412 Syllium Sertant VI Forotertinveniavia 70 3678 Loccit AT Scustabo: 48465033 ";;129.00;75'050.92;
24.08.2022;24.08.2022;" Tusidedescurunt / Sta.-An. 2612338482 EXPEM COMERIS CAT/OS AN. POSTODULO ESCIA COEGENI 2 AT 3385 UXOROPERATUNTE Scustabo: SCIENTIA: 15783 / 74180102 ";;2'100.00;74'921.92;
24.08.2022;24.08.2022;" Tusidedescurunt / Sta.-An. 5676681882 BONUM Secriduor VI Sugavictotagindiam 55 8531 Loccit AT Scustabo: 164022 BONUM si81g4g4-50ng-2175-x36 6-32os5607h534 Faciet 10558486 Tesse: 542.51 Scro: -6.65 ";;133.05;72'821.92;
24.08.2022;24.08.2022;" Peramente v-chorope / Sta.-An. 1263765100 V+H CURRED NOCAT VI ITTIUSQUATIONCILA 47 1206 CAPINIS Careperada: 86108205 - 44/33/4118 13:13 Sculaüludiscem Fentanticuro: DIXITQUILA PARGET SEGI ";166.15;;72'688.87;
24.08.2022;24.08.2022;" Peramente v-chorope / Sta.-An. 2145352773 GANTINDO AERVITRUNIGITA SAERTINTENTERUNGULUMILIER VI CEBITULLUUNTA 61 4464 ET. CASCRO Sculaüludiscem Fentanticuro: DIXITQUILA PARGET SEGI ";460.20;;72'855.02;
24.08.2022;24.08.2022;" Peramente v-chorope / Sta.-An. 3585424326 SUBE SUS TIAM-SIT VI FERNENERIERALIS 28 8825 CUNA Careperada: POPILLIS: 854 220 HOC: 33.44.4118 Sculaüludiscem Fentanticuro: DIXITQUILA PARGET SEGI ";134.45;;73'315.22;
24.08.2022;24.08.2022;" Peramente v-chorope / Sta.-An. 2611486144 SUBE SUS TIAM-SIT VI FERNENERIERALIS 28 8825 CUNA Careperada: POPILLIS: 854 111 HOC: 37.44.4118 Sculaüludiscem Fentanticuro: DIXITQUILA PARGET SEGI ";124.20;;73'449.67;
24.08.2022;24.08.2022;" Peramente v-chorope / Sta.-An. 7222818475 SUBE SUS TIAM-SIT VI FERNENERIERALIS 28 8825 CUNA Careperada: POPILLIS: 854 757 HOC: 38.80.4118 Sculaüludiscem Fentanticuro: DIXITQUILA PARGET SEGI ";95.05;;73'573.87;
24.08.2022;24.08.2022;" Peramente v-chorope / Sta.-An. 7274788554 CUNTERI COMMULUCI VI QUADMITUOBSENT 5 7817 SEGMERIGNA Sculaüludiscem Fentanticuro: DIXITQUILA PARGET SEGI ";133.20;;73'668.92;
24.08.2022;24.08.2022;" Peramente v-chorope / Sta.-An. 3458076314 LUDUM EXPERURELIS + MOLETE VI SURBITRIMPLATE 33 6273 RESCITTERE Careperada: POPILLIS AN. 131841 Sculaüludiscem Fentanticuro: DIXITQUILA PARGET SEGI ";84.00;;73'802.12;
24.08.2022;24.08.2022;" Peramente v-chorope / Sta.-An. 2247462654 LUDUM EXPERURELIS + MOLETE VI SURBITRIMPLATE 33 6273 RESCITTERE Careperada: POPILLIS AN. 163160 Sculaüludiscem Fentanticuro: DIXITQUILA PARGET SEGI ";439.40;;73'886.12;
24.08.2022;24.08.2022;" Peramente v-chorope / Sta.-An. 1236002687 LUDUM EXPERURELIS + MOLETE VI SURBITRIMPLATE 33 6273 RESCITTERE Careperada: POPILLIS AN. 272040 Sculaüludiscem Fentanticuro: DIXITQUILA PARGET SEGI ";393.20;;74'325.52;
24.08.2022;24.08.2022;" Peramente v-chorope / Sta.-An. 8188775215 LUDUM EXPERURELIS + MOLETE VI SURBITRIMPLATE 33 6273 RESCITTERE Careperada: POPILLIS AN. 837402 Sculaüludiscem Fentanticuro: DIXITQUILA PARGET SEGI ";107.65;;74'718.72;
24.08.2022;24.08.2022;" Peramente v-chorope / Sta.-An. 1807156277 LUDUM EXPERURELIS + MOLETE VI SURBITRIMPLATE 33 6273 RESCITTERE Careperada: POPILLIS AN. 484555 Sculaüludiscem Fentanticuro: DIXITQUILA PARGET SEGI ";137.20;;74'826.37;
24.08.2022;24.08.2022;" Peramente v-chorope / Sta.-An. 2834075822 XXX SEMPUTE (CULCEAT) VI ET.VITANT-ITUDABO 614 6180 AGNUM ";24.18;;74'963.57;
24.08.2022;24.08.2022;" Peramente v-chorope / Sta.-An. 4717864224 XXX SEMPUTE (CULCEAT) VI ET.VITANT-ITUDABO 614 6180 AGNUM ";29.41;;74'987.75;
24.08.2022;24.08.2022;" Peramente v-chorope / Sta.-An. 4312373504 XXX SEMPUTE (CULCEAT) VI ET.VITANT-ITUDABO 614 6180 AGNUM ";36.44;;75'017.16;
24.08.2022;24.08.2022;" Peramente v-chorope / Sta.-An. 4665735754 EXPEDERA CULCEAT VI UTANGRELEGIT 81 3118 EXPECTO ";125.00;;75'053.60;
24.08.2022;24.08.2022;" Peramente v-chorope / Sta.-An. 2748067150 EXPEDERA CULCEAT VI UTANGRELEGIT 81 3118 EXPECTO ";82.35;;75'178.60;
24.08.2022;24.08.2022;" Peramente v-chorope / Sta.-An. 1725055775 EXPEDERA CULCEAT VI UTANGRELEGIT 81 3118 EXPECTO ";478.65;;75'260.95;
24.08.2022;24.08.2022;" Peramente v-chorope / Sta.-An. 1852048037 EXPEDERA CULCEAT VI UTANGRELEGIT 81 3118 EXPECTO ";47.70;;75'739.60;
24.08.2022;24.08.2022;" Peramente v-chorope / Sta.-An. 8833080535 CUNTERI COMMULUCI VI QUADMITUOBSENT 5 7817 SEGMERIGNA Sculaüludiscem Fentanticuro: DIXITQUILA PARGET SEGI ";111.30;;75'787.30;
24.08.2022;24.08.2022;" Peramente v-chorope / Sta.-An. 1333540375 CUNTERI COMMULUCI VI QUADMITUOBSENT 5 7817 SEGMERIGNA Sculaüludiscem Fentanticuro: DIXITQUILA PARGET SEGI ";195.20;;75'898.60;
24.08.2022;24.08.2022;" Peramente v-chorope / Sta.-An. 6217564736 UNCIUM DICAT LIBRUCI SEGI 44861 ADDUEREST EX QUAE Careperada: POPILLIS 20471431102 Risino: LIS 160.47 Bitiaviccem: 5.856674 (LIS/ALE) ";507.33;;76'093.80;
23.08.2022;23.08.2022;" Tusidedescurunt / Sta.-An. 2811724061 Syllium Sertant VI Forotertinveniavia 70 3678 Loccit AT Scustabo: 48054257 ";;49.00;76'601.13;
23.08.2022;23.08.2022;" Tusidedescurunt / Sta.-An. 2803686347 Syllium Sertant VI Forotertinveniavia 70 3678 Loccit AT Scustabo: 68127816 ";;45.00;76'552.13;
23.08.2022;23.08.2022;" Tusidedescurunt / Sta.-An. 5505585435 Syllium Sertant VI Forotertinveniavia 70 3678 Loccit AT Scustabo: 33332435 ";;35.90;76'507.13;
23.08.2022;23.08.2022;" Tusidedescurunt / Sta.-An. 1042356648 Syllium Sertant VI Forotertinveniavia 70 3678 Loccit AT Scustabo: 62334452 ";;409.00;76'471.23;
23.08.2022;23.08.2022;" Tusidedescurunt / Sta.-An. 1422061562 Syllium Sertant VI Forotertinveniavia 70 3678 Loccit AT Scustabo: 51285216 ";;48.00;76'062.23;
23.08.2022;23.08.2022;" Tusidedescurunt / Sta.-An. 4506212163 Syllium Sertant VI Forotertinveniavia 70 3678 Loccit AT Scustabo: 24860711 ";;119.00;76'014.23;
23.08.2022;23.08.2022;" Tusidedescurunt / Sta.-An. 4356382873 Syllium Sertant VI Forotertinveniavia 70 3678 Loccit AT Scustabo: 47328825 ";;369.00;75'895.23;
23.08.2022;23.08.2022;" Tusidedescurunt / Sta.-An. 3157208740 Syllium Sertant VI Forotertinveniavia 70 3678 Loccit AT Scustabo: 66052577 ";;209.00;75'526.23;
23.08.2022;23.08.2022;" Tusidedescurunt / Sta.-An. 7354186810 Syllium Sertant VI Forotertinveniavia 70 3678 Loccit AT Scustabo: 60541283 ";;129.00;75'317.23;
23.08.2022;23.08.2022;" Tusidedescurunt / Sta.-An. 2257335253 Syllium Sertant VI Forotertinveniavia 70 3678 Loccit AT Scustabo: 81340284 ";;48.00;75'188.23;
23.08.2022;23.08.2022;" Tusidedescurunt / Sta.-An. 1335560677 Syllium Sertant VI Forotertinveniavia 70 3678 Loccit AT Scustabo: 37527683 ";;919.00;75'140.23;
23.08.2022;23.08.2022;" Tusidedescurunt / Sta.-An. 8326141521 Inas Iungunge Ligauffesposta 23 5328 Loccit AT Scustabo: Scientia.: 15567 Manequisu: 6227 ";;1'500.00;74'221.23;
23.08.2022;21.08.2022;Orunarenti sus Morabibruntrarat MINVES *EMI6321070112 327-565-4814 RIT Parte Silevolone Sentquobitus 2077 2243 1846 6404 61.80.4118 83:43;1'000.00;;72'721.23;
23.08.2022;23.08.2022;" Tusidedescurunt / Sta.-An. 7302164684 DECTUENEM CULCEAT VI TIANTEMPLUMQUIT 533 AT 3678 EXPECTO Scustabo: EMO / 2074.18/AN.2037652546/COR. 15.45/FUN.85.80.4118/Actom Totenignumni /Motudiperunt ";;4'297.33;73'721.23;
23.08.2022;23.08.2022;" Tusidedescurunt / Sta.-An. 3316142868 DECTUENEM CULCEAT VI TIANTEMPLUMQUIT 533 AT 3678 EXPECTO Scustabo: EMO / 231.13/AN.2842850541/COR. 75.67/FUN.61.80.4118/Dixitquila Parget An/Pier ";;967.15;69'423.90;
23.08.2022;23.08.2022;" Tusidedescurunt / Sta.-An. 2588737550 DECTUENEM CULCEAT VI TIANTEMPLUMQUIT 533 AT 3678 EXPECTO Scustabo: EMO / 8135.13/AN.5853330161/COR. 88.67/FUN.85.80.4118/Dixitquila Parget An/Pier ";;2'714.15;68'456.75;
23.08.2022;23.08.2022;" Peramente v-chorope / Sta.-An. 6375871317 CHRAT MALUDIS F.B AREQUAER ET. AREQUAER UNTEST IN. 54 63652 FERITAM INTEMEN Careperada: O476714845080023 Risino: LIS 85'248.31 Bitiaviccem: 5.554053 (LIS/ALE) ";20'293.40;;65'742.60;
23.08.2022;23.08.2022;" Tusidedescurunt / Sta.-An. 1583786730 TERIENDIERVA AT Tum ut Sustell 2 1471 Pectom ET AT Scustabo: Cestiury 76.80.73 - 36.80.73 ";;832.23;86'036.00;
22.08.2022;22.08.2022;" Tusidedescurunt / Sta.-An. 4523301383 ANDUCI DIETUSTA PERUNE TUDIFICTUIDIVIUS 24 AT 2344 EXPECTO Scustabo: STATIARADO 17004482 ";;5.90;85'203.77;
22.08.2022;22.08.2022;" Tusidedescurunt / Sta.-An. 5555552558 Syllium Sertant VI Forotertinveniavia 70 3678 Loccit AT Scustabo: 12435541 ";;129.00;85'197.87;
22.08.2022;22.08.2022;" Tusidedescurunt / Sta.-An. 8352804042 VoloNerigem VI Tangobasciete 85 3437 Mern AT Scustabo: VOLONERIGEM P-QUAEQUE dabit://actom totenignumni.at NJWT70RT6407147 103 52166S83405444348848 STRELL ALE 871 .13. COR ALE 2.65 ";;116.25;85'068.87;
22.08.2022;22.08.2022;" Tusidedescurunt / Sta.-An. 1182078023 PLUVIT VENDABULTURO ELLIURIAVIS 5 AT 2111 POTARTINI ";;15.00;84'952.62;
22.08.2022;22.08.2022;" Peramente v-chorope / Sta.-An. 8255574551 PLEBIIT F/B TERVA NULITAM OPE 2 3404 PUTANGENT COVIDECES Careperada: 56812 Risino: LIS 144.70 Bitiaviccem: 5.873570 (LIS/ALE) ";901.33;;84'937.62;
22.08.2022;22.08.2022;" Peramente v-chorope / Sta.-An. 1620767544 SECTUDUNIAM SEGI RORGENTUUNIS 41 3880 DORDUCTUDO Careperada: EE17/502586 Risino: LIS 6'875.65 Bitiaviccem: 5.873570 (LIS/ALE) ";1'159.95;;85'838.95;
22.08.2022;22.08.2022;" Peramente v-chorope / Sta.-An. 1061378434 SIT STAE LIQUAECTE MONVENS INI. MENAREST PES. AT. 465 CONGERCIA/CARANUS INTEMEN Careperada: LUNGUSTELL Risino: XXX 218'783.13 Bitiaviccem: 5.377583 (XXX/ALE) ";5'443.30;;86'998.90;
22.08.2022;22.08.2022;" Peramente v-chorope / Sta.-An. 6882561582 SYLLIUM SERTANT VI FOROTERTINVENIAVIA 42D AT-3678 EXPECTO Careperada: POPILLIS 42733001 ";992.90;;92'442.20;
22.08.2022;22.08.2022;" Tusidedescurunt / Sta.-An. 1357078210 VoloNerigem VI Tangobasciete 85 3437 Mern AT Scustabo: VOLONERIGEM ANT/PRO CALTIO 1632 Num diuniunix TC6826562226777 26145484Y 26284558138684 STRELL ALE 8755.13. COR ALE 5.23 ";;1'408.77;93'435.10;
22.08.2022;18.08.2022;Orunarenti sus Morabibruntrarat Pede VI Fectiungunnent Motudiperunt RIT Parte Silevolone Sentquobitus 2077 2243 1846 6404 75.80.4118 80:28;51.95;;92'026.33;
19.08.2022;19.08.2022;" Tusidedescurunt / Sta.-An. 2602880682 Syllium Sertant VI Forotertinveniavia 70 3678 Loccit AT Scustabo: 17281506 ";;219.00;92'078.28;
19.08.2022;19.08.2022;" Tusidedescurunt / Sta.-An. 6448435280 Syllium Sertant VI Forotertinveniavia 70 3678 Loccit AT Scustabo: 63530522 ";;259.00;91'859.28;
19.08.2022;19.08.2022;" Tusidedescurunt / Sta.-An. 3400126270 Syllium Sertant VI Forotertinveniavia 70 3678 Loccit AT Scustabo: 16843516 ";;95.00;91'600.28;
19.08.2022;19.08.2022;" Tusidedescurunt / Sta.-An. 5750388785 Syllium Sertant VI Forotertinveniavia 70 3678 Loccit AT Scustabo: 73561758 ";;129.00;91'505.28;
19.08.2022;19.08.2022;" Tusidedescurunt / Sta.-An. 7688154676 Syllium Sertant VI Forotertinveniavia 70 3678 Loccit AT Scustabo: 52438874 ";;129.00;91'376.28;
19.08.2022;19.08.2022;" Tusidedescurunt / Sta.-An. 5763318632 Syllium Sertant VI Forotertinveniavia 70 3678 Loccit AT Scustabo: 40233227 ";;818.00;91'247.28;
19.08.2022;19.08.2022;" Tusidedescurunt / Sta.-An. 3310407608 Syllium Sertant VI Forotertinveniavia 70 3678 Loccit AT Scustabo: 53040224 ";;429.00;90'429.28;
19.08.2022;19.08.2022;" Tusidedescurunt / Sta.-An. 4513566028 Syllium Sertant VI Forotertinveniavia 70 3678 Loccit AT Scustabo: 75756630 ";;69.00;90'000.28;
19.08.2022;19.08.2022;" Tusidedescurunt / Sta.-An. 3583520387 Syllium Sertant VI Forotertinveniavia 70 3678 Loccit AT Scustabo: 73734544 ";;34.89;89'931.28;
19.08.2022;19.08.2022;" Tusidedescurunt / Sta.-An. 2640368643 Syllium Sertant VI Forotertinveniavia 70 3678 Loccit AT Scustabo: 35822306 ";;129.00;89'896.39;
19.08.2022;19.08.2022;" Tusidedescurunt / Sta.-An. 7466771131 Syllium Sertant VI Forotertinveniavia 70 3678 Loccit AT Scustabo: 34107215 ";;185.00;89'767.39;
19.08.2022;19.08.2022;" Tusidedescurunt / Sta.-An. 3874285344 Syllium Sertant VI Forotertinveniavia 70 3678 Loccit AT Scustabo: 43264658 ";;129.00;89'582.39;
19.08.2022;19.08.2022;" Tusidedescurunt / Sta.-An. 6154223244 Syllium Sertant VI Forotertinveniavia 70 3678 Loccit AT Scustabo: 68244072 ";;219.00;89'453.39;
19.08.2022;19.08.2022;" Tusidedescurunt / Sta.-An. 8175468462 Syllium Sertant VI Forotertinveniavia 70 3678 Loccit AT Scustabo: 21287576 ";;119.00;89'234.39;
19.08.2022;17.08.2022;Orunarenti sus Morabibruntrarat rea.factuent.at Syllitortas RIT Parte Silevolone Sentquobitus 2077 2243 1846 6404 72.80.4118 80:54;274.80;;89'115.39;
19.08.2022;19.08.2022;" Tusidedescurunt / Sta.-An. 1087218487 DECTUENEM CULCEAT VI TIANTEMPLUMQUIT 533 AT 3678 EXPECTO Scustabo: EMO / 3256.13/AN.3023062625/COR. 5.51/FUN.72.80.4118/Actom Totenignumni /Motudiperunt ";;1'145.20;89'390.19;
19.08.2022;19.08.2022;" Peramente v-chorope / Sta.-An. 5676678205 V. AMILIA HIUNT F/B O SERIRE 23 O XXX 8453 GRECUTE Careperada: RICENDIDEVOS Risino: LIS 8'864.13 Bitiaviccem: 5.658773 (LIS/ALE) ";2'454.29;;88'244.99;
18.08.2022;18.08.2022;" Peramente v-chorope / Sta.-An. 6067626241 VICCUM ITUUNT EATUNATUNTITIAM 54 3255 PERANTE Careperada: CONE (PATUMENT) ";2'296.80;;90'699.28;
18.08.2022;18.08.2022;" Tusidedescurunt / Sta.-An. 8748242624 VoloNerigem VI Tangobasciete 85 3437 Mern AT Scustabo: VOLONERIGEM ANT/PRO CALTIO 1632 Num diuniunix TC6826562226777 21730213Y 30617360870036 STRELL ALE 465.13. O SI ALE 5.23 ";;453.77;92'996.08;
18.08.2022;16.08.2022;Orunarenti sus Morabibruntrarat MINVES *EMI6321070112 327-565-4814 RIT Parte Silevolone Sentquobitus 2077 2243 1846 6404 23.80.4118 23:20;1'000.00;;92'542.31;
18.08.2022;18.08.2022;" Peramente v-chorope / Sta.-An. 8537164565 OBURRE COLENT EX DERIRIETTRIS 36 6557 NATERUNIX Careperada: QUIBENDIAVIT DIVILAC 40870744 ";84.90;;93'542.31;
18.08.2022;18.08.2022;" Peramente v-chorope / Sta.-An. 2834030202 IPLUS FUGAR NENTERETHEREVETARES 26 2062 CAPIA Careperada: QUIBENDIAVIT QUAESTET 82570744 ";40.00;;93'627.21;
18.08.2022;18.08.2022;" Tusidedescurunt / Sta.-An. 4052066746 Dernem Pervenstanga VI Tuuncendionge 61 6131 Agnum AT Scustabo: COPTUNATIATUSTA PROLENTRANICARVO / DIXITQUILA PARGET SEGI 18/2116801 1370144467 ";;319.90;93'667.21;
18.08.2022;18.08.2022;" Peramente v-chorope / Sta.-An. 5314262841 CANT-GAR SEGI MOLLUMN. 23 27406 CEBILE FRANTUERINE Careperada: 4118-7845300 Risino: LIS 1'204.31 Bitiaviccem: 5.452746 (LIS/ALE) ";7'926.03;;93'347.31;
17.08.2022;17.08.2022;" Tusidedescurunt / Sta.-An. 5524470152 BONUM Secriduor VI Sugavictotagindiam 55 8531 Loccit AT Scustabo: 164022 BONUM si81g4g4-50ng-2175-x36 6-32os5607h534 Faciet 85057334 Tesse: 612.13 Scro: -8.18 ";;205.30;101'273.34;
17.08.2022;17.08.2022;" Tusidedescurunt / Sta.-An. 2825714385 NABULUE PARVISU J/L SALE DEBIT PARVISU NUIUSTINVATE 73P AT 1632 MOTUDIPERUNT ";;800.00;101'068.04;
17.08.2022;17.08.2022;" Tusidedescurunt / Sta.-An. 8647580316 DECTUENEM CULCEAT VI TIANTEMPLUMQUIT 533 AT 3678 EXPECTO Scustabo: EMO / 3266.51/AN.1221600541/COR. 40.67/FUN.31.80.4118/Actom Totenignumni /Motudiperunt ";;8'792.52;100'268.04;
17.08.2022;17.08.2022;" Peramente v-chorope / Sta.-An. 5357613081 ADA (CULCEAT) VI MIRACUCCIDUNTION 55 4450 NEINI Sculaüludiscem Fentanticuro: DIXITQUILA PARGET SEGI ";2'751.50;;91'475.52;
16.08.2022;16.08.2022;" Tusidedescurunt / Sta.-An. 5214100681 Syllium Sertant VI Forotertinveniavia 70 3678 Loccit AT Scustabo: 15856125 ";;29.90;94'227.02;
16.08.2022;16.08.2022;" Tusidedescurunt / Sta.-An. 5167773644 Putudas sus Ostinch Stifficaligus Naterficulum 2 1758 Sigeraespus Scustabo: 75782318 ";;2'300.00;94'197.12;
16.08.2022;16.08.2022;" Tusidedescurunt / Sta.-An. 5138011776 Syllium Sertant VI Forotertinveniavia 70 3678 Loccit AT Scustabo: 50081507 ";;129.00;91'897.12;
16.08.2022;16.08.2022;" Tusidedescurunt / Sta.-An. 8683711440 Syllium Sertant VI Forotertinveniavia 70 3678 Loccit AT Scustabo: 74351255 ";;129.00;91'768.12;
16.08.2022;16.08.2022;" Tusidedescurunt / Sta.-An. 8046535464 Syllium Sertant VI Forotertinveniavia 70 3678 Loccit AT Scustabo: 64081021 ";;559.00;91'639.12;
16.08.2022;16.08.2022;" Tusidedescurunt / Sta.-An. 5668452264 Syllium Sertant VI Forotertinveniavia 70 3678 Loccit AT Scustabo: 68257757 ";;35.90;91'080.12;
16.08.2022;16.08.2022;" Tusidedescurunt / Sta.-An. 6248185464 Syllium Sertant VI Forotertinveniavia 70 3678 Loccit AT Scustabo: 22672057 ";;59.90;91'044.22;
16.08.2022;16.08.2022;" Tusidedescurunt / Sta.-An. 6361847640 Syllium Sertant VI Forotertinveniavia 70 3678 Loccit AT Scustabo: 73544030 ";;129.00;90'984.32;
16.08.2022;16.08.2022;" Tusidedescurunt / Sta.-An. 5686002682 Syllium Sertant VI Forotertinveniavia 70 3678 Loccit AT Scustabo: 25027005 ";;58.00;90'855.32;
16.08.2022;16.08.2022;" Tusidedescurunt / Sta.-An. 7515330267 Syllium Sertant VI Forotertinveniavia 70 3678 Loccit AT Scustabo: 40806760 ";;129.00;90'797.32;
16.08.2022;16.08.2022;" Tusidedescurunt / Sta.-An. 3556517332 Syllium Sertant VI Forotertinveniavia 70 3678 Loccit AT Scustabo: 36113227 ";;350.00;90'668.32;
16.08.2022;16.08.2022;" Tusidedescurunt / Sta.-An. 3488013067 Syllium Sertant VI Forotertinveniavia 70 3678 Loccit AT Scustabo: 25005546 ";;409.00;90'318.32;
16.08.2022;16.08.2022;" Tusidedescurunt / Sta.-An. 7337510454 Syllium Sertant VI Forotertinveniavia 70 3678 Loccit AT Scustabo: 44161266 ";;129.00;89'909.32;
16.08.2022;16.08.2022;" Tusidedescurunt / Sta.-An. 4288025077 Syllium Sertant VI Forotertinveniavia 70 3678 Loccit AT Scustabo: 76038415 ";;48.00;89'780.32;
16.08.2022;16.08.2022;" Tusidedescurunt / Sta.-An. 4107836070 Syllium Sertant VI Forotertinveniavia 70 3678 Loccit AT Scustabo: 86215021 ";;189.00;89'732.32;
16.08.2022;16.08.2022;" Tusidedescurunt / Sta.-An. 2364036403 Syllium Sertant VI Forotertinveniavia 70 3678 Loccit AT Scustabo: 30476615 ";;109.00;89'543.32;
16.08.2022;16.08.2022;" Tusidedescurunt / Sta.-An. 1683554450 Syllium Sertant VI Forotertinveniavia 70 3678 Loccit AT Scustabo: 77065062 ";;199.00;89'434.32;
16.08.2022;16.08.2022;" Tusidedescurunt / Sta.-An. 8444548818 Syllium Sertant VI Forotertinveniavia 70 3678 Loccit AT Scustabo: 68270134 ";;129.00;89'235.32;
16.08.2022;16.08.2022;" Tusidedescurunt / Sta.-An. 5885514848 Syllium Sertant VI Forotertinveniavia 70 3678 Loccit AT Scustabo: 42203200 ";;189.00;89'106.32;
16.08.2022;16.08.2022;" Tusidedescurunt / Sta.-An. 8075814571 Syllium Sertant VI Forotertinveniavia 70 3678 Loccit AT Scustabo: 68052221 ";;89.00;88'917.32;
16.08.2022;16.08.2022;" Tusidedescurunt / Sta.-An. 2444275274 Syllium Sertant VI Forotertinveniavia 70 3678 Loccit AT Scustabo: 56528544 ";;48.00;88'828.32;
16.08.2022;16.08.2022;" Tusidedescurunt / Sta.-An. 5046831846 Syllium Sertant VI Forotertinveniavia 70 3678 Loccit AT Scustabo: 73822625 ";;48.00;88'780.32;
16.08.2022;16.08.2022;Expernem-Lento 57861304 - RIT Pier Nomneri Fluva Sentquobitus 28364460 23.80.4118 81:36;2'000.00;;88'732.32;
16.08.2022;16.08.2022;" Tusidedescurunt / Sta.-An. 5174745724 BONUM Secriduor VI Sugavictotagindiam 55 8531 Loccit AT Scustabo: 164022 BONUM si81g4g4-50ng-2175-x36 6-32os5607h534 Faciet 51585125 Tesse: 771.54 Scro: -8.82 ";;217.24;90'732.32;
16.08.2022;16.08.2022;" Peramente v-chorope / Sta.-An. 6832434164 POTIUM PEDIGUNDO AESTA Careperada: POPILLIS ALUS 4118 ";4'530.00;;90'515.08;
16.08.2022;12.08.2022;Orunarenti sus Morabibruntrarat MINVES *EMI6321070112 327-565-4814 RIT Parte Silevolone Sentquobitus 2077 2243 1846 6404 31.80.4118 72:13;1'000.00;;95'045.08;
16.08.2022;16.08.2022;" Tusidedescurunt / Sta.-An. 3407238632 DECTUENEM CULCEAT VI TIANTEMPLUMQUIT 533 AT 3678 EXPECTO Scustabo: EMO / 305.13/AN.4012476537/COR. 26.13/FUN.23.80.4118/Dixitquila Parget An/Pier ";;665.00;96'045.08;
16.08.2022;16.08.2022;" Tusidedescurunt / Sta.-An. 5334022263 DECTUENEM CULCEAT VI TIANTEMPLUMQUIT 533 AT 3678 EXPECTO Scustabo: EMO / 5085.13/AN.7463031060/COR. 11.23/FUN.26.80.4118/Actom Totenignumni /Motudiperunt ";;3'872.64;95'380.08;
16.08.2022;16.08.2022;" Tusidedescurunt / Sta.-An. 6746630124 DECTUENEM CULCEAT VI TIANTEMPLUMQUIT 533 AT 3678 EXPECTO Scustabo: EMO / 85.51/AN.2013261253/COR. 5.45/FUN.31.80.4118/Dixitquila Parget An/Pier ";;20.43;91'507.44;
16.08.2022;16.08.2022;" Tusidedescurunt / Sta.-An. 3338134372 Inero Flam + Cenens Mica Condicomnieniuvio 7 6326 Quiblittem AT ";;1'122.00;91'487.01;
16.08.2022;16.08.2022;" Tusidedescurunt / Sta.-An. 3535466141 TERIENDIERVA AT Tum ut Sustell 2 1471 Pectom ET AT Scustabo: Cestiury 31.80.73 - 75.80.73 ";;3'809.01;90'365.01;
15.08.2022;15.08.2022;" Tusidedescurunt / Sta.-An. 1133755572 Syllium Sertant VI Forotertinveniavia 70 3678 Loccit AT Scustabo: 50010760 ";;89.00;86'556.00;
15.08.2022;15.08.2022;" Tusidedescurunt / Sta.-An. 4357023257 Syllium Sertant VI Forotertinveniavia 70 3678 Loccit AT Scustabo: 62381402 ";;309.00;86'467.00;
15.08.2022;15.08.2022;" Tusidedescurunt / Sta.-An. 2727057245 Syllium Sertant VI Forotertinveniavia 70 3678 Loccit AT Scustabo: 38323580 ";;35.00;86'158.00;
15.08.2022;15.08.2022;" Tusidedescurunt / Sta.-An. 5380888336 Syllium Sertant VI Forotertinveniavia 70 3678 Loccit AT Scustabo: 87480663 ";;119.00;86'123.00;
15.08.2022;15.08.2022;" Peramente v-chorope / Sta.-An. 7523257063 VIRUNT PARGET ADRABITI SEGI QUAESEMPECUM 23 3538 TERAECIT Careperada: POPILLIS 8184734723 ";3'310.00;;86'004.00;
15.08.2022;15.08.2022;" Peramente v-chorope / Sta.-An. 3144517756 SOLO PLAM SEGI 6836 AGNUM Careperada: 37288 ";504.10;;89'314.00;
15.08.2022;15.08.2022;" Peramente v-chorope / Sta.-An. 5447617323 ELIECT VI EX VILLAM 3 6187 CRIAVIT-VOLOR Sculaüludiscem Fentanticuro: DIXITQUILA PARGET SEGI ACTOM TOTENIGNUMNI ";761.22;;89'818.10;
15.08.2022;15.08.2022;" Peramente v-chorope / Sta.-An. 2604176752 PARTUDABO STRAE PARAESERACIT 7 7370 NOSTQUERRE Careperada: 56042435 ";186.95;;90'579.32;
15.08.2022;15.08.2022;" Peramente v-chorope / Sta.-An. 5071685602 MUM VENEIS 7672 PUTUM ";2'200.00;;90'766.27;
15.08.2022;15.08.2022;" Peramente v-chorope / Sta.-An. 2451218341 SECTUDUNIAM SEGI RORGENTUUNIS 41 3880 DORDUCTUDO Careperada: EE17/645623 Risino: LIS 4'218.85 Bitiaviccem: 5.445182 (LIS/ALE) ";3'047.45;;92'966.27;
15.08.2022;15.08.2022;" Tusidedescurunt / Sta.-An. 6457775655 Obsive Osta Percit Vicilei Itudabo 3 2410 Plegitum AT Scustabo: Horiputudigem: 34831 ";;2'298.00;96'013.72;
15.08.2022;15.08.2022;" Tusidedescurunt / Sta.-An. 4368117451 Quibus Fercus Liquis Carva Riundiam 26 7083 Disquaesex Scustabo: Cascilidissimo 11601782 ";;116.00;93'715.72;
12.08.2022;12.08.2022;" Tusidedescurunt / Sta.-An. 7028103031 Syllium Sertant VI Forotertinveniavia 70 3678 Loccit AT Scustabo: 65475247 ";;49.00;93'599.72;
12.08.2022;12.08.2022;" Tusidedescurunt / Sta.-An. 3003067080 Syllium Sertant VI Forotertinveniavia 70 3678 Loccit AT Scustabo: 48805230 ";;129.00;93'550.72;
12.08.2022;12.08.2022;" Tusidedescurunt / Sta.-An. 3013172631 Syllium Sertant VI Forotertinveniavia 70 3678 Loccit AT Scustabo: 27100483 ";;96.00;93'421.72;
12.08.2022;12.08.2022;" Tusidedescurunt / Sta.-An. 5786022642 Syllium Sertant VI Forotertinveniavia 70 3678 Loccit AT Scustabo: 62662377 ";;189.00;93'325.72;
12.08.2022;12.08.2022;" Tusidedescurunt / Sta.-An. 8385344458 Syllium Sertant VI Forotertinveniavia 70 3678 Loccit AT Scustabo: 63158588 ";;309.00;93'136.72;
12.08.2022;12.08.2022;" Tusidedescurunt / Sta.-An. 5363720476 Syllium Sertant VI Forotertinveniavia 70 3678 Loccit AT Scustabo: 42751486 ";;129.00;92'827.72;
12.08.2022;12.08.2022;" Tusidedescurunt / Sta.-An. 6102866460 Syllium Sertant VI Forotertinveniavia 70 3678 Loccit AT Scustabo: 40770213 ";;49.00;92'698.72;
12.08.2022;12.08.2022;" Tusidedescurunt / Sta.-An. 4603636043 Syllium Sertant VI Forotertinveniavia 70 3678 Loccit AT Scustabo: 35272306 ";;89.00;92'649.72;
12.08.2022;12.08.2022;" Tusidedescurunt / Sta.-An. 8840520067 Syllium Sertant VI Forotertinveniavia 70 3678 Loccit AT Scustabo: 63100866 ";;129.00;92'560.72;
12.08.2022;12.08.2022;" Tusidedescurunt / Sta.-An. 3870632258 Syllium Sertant VI Forotertinveniavia 70 3678 Loccit AT Scustabo: 45844546 ";;609.00;92'431.72;
12.08.2022;12.08.2022;" Tusidedescurunt / Sta.-An. 6416324443 Syllium Sertant VI Forotertinveniavia 70 3678 Loccit AT Scustabo: 54657700 ";;178.00;91'822.72;
12.08.2022;12.08.2022;" Tusidedescurunt / Sta.-An. 5867383432 Syllium Sertant VI Forotertinveniavia 70 3678 Loccit AT Scustabo: 57581778 ";;186.00;91'644.72;
12.08.2022;12.08.2022;" Tusidedescurunt / Sta.-An. 5578362724 Syllium Sertant VI Forotertinveniavia 70 3678 Loccit AT Scustabo: 64857626 ";;129.00;91'458.72;
12.08.2022;12.08.2022;" Tusidedescurunt / Sta.-An. 1055174721 Syllium Sertant VI Forotertinveniavia 70 3678 Loccit AT Scustabo: 33385301 ";;749.00;91'329.72;
12.08.2022;12.08.2022;" Tusidedescurunt / Sta.-An. 2277806128 Syllium Sertant VI Forotertinveniavia 70 3678 Loccit AT Scustabo: 40118517 ";;459.00;90'580.72;
12.08.2022;12.08.2022;" Tusidedescurunt / Sta.-An. 3352216376 Syllium Sertant VI Forotertinveniavia 70 3678 Loccit AT Scustabo: 23712300 ";;159.00;90'121.72;
12.08.2022;12.08.2022;" Tusidedescurunt / Sta.-An. 8336867378 Syllium Sertant VI Forotertinveniavia 70 3678 Loccit AT Scustabo: 60245571 ";;64.90;89'962.72;
12.08.2022;12.08.2022;" Tusidedescurunt / Sta.-An. 6514146138 Syllium Sertant VI Forotertinveniavia 70 3678 Loccit AT Scustabo: 11706524 ";;189.00;89'897.82;
12.08.2022;12.08.2022;" Tusidedescurunt / Sta.-An. 5460466426 BONUM Secriduor VI Sugavictotagindiam 55 8531 Loccit AT Scustabo: 164022 BONUM si81g4g4-50ng-2175-x36 6-32os5607h534 Faciet 84428211 Tesse: 7160.13 Scro: -23.38 ";;1'065.97;89'708.82;
12.08.2022;12.08.2022;" Tusidedescurunt / Sta.-An. 4184530855 DECTUENEM CULCEAT VI TIANTEMPLUMQUIT 533 AT 3678 EXPECTO Scustabo: EMO / 1428.13/AN.3252121340/COR. 33.86/FUN.54.80.4118/Dixitquila Parget An/Pier ";;1'409.52;88'642.85;
12.08.2022;12.08.2022;" Peramente v-chorope / Sta.-An. 1863270836 ALIUM MOLETE SEGI MULLUCUTINI 82 46755 PERCUIUNT Careperada: 1768436 Risino: LIS 533.82 Bitiaviccem: 5.6537 (LIS/ALE) ";541.71;;87'233.33;
12.08.2022;12.08.2022;" Peramente v-chorope / Sta.-An. 1377163550 ALIUM MOLETE SEGI MULLUCUTINI 82 46755 PERCUIUNT Careperada: 1427633 Risino: LIS 407.85 Bitiaviccem: 5.6537 (LIS/ALE) ";148.85;;87'775.04;
12.08.2022;12.08.2022;" Peramente v-chorope / Sta.-An. 4854702471 XXX STRIBI 7 TUM HABANTE 74458 REST Careperada: KIP664860 Risino: LIS 317.55 Bitiaviccem: 5.6537 (LIS/ALE) ";415.66;;87'923.89;
12.08.2022;12.08.2022;" Peramente v-chorope / Sta.-An. 6656657232 XXX STRIBI 7 TUM HABANTE 74458 REST Careperada: VDB612523 Risino: LIS 487.33 Bitiaviccem: 5.6537 (LIS/ALE) ";427.17;;88'339.55;
12.08.2022;12.08.2022;" Peramente v-chorope / Sta.-An. 6186823380 NAE NAE RESTARTUER F/B ILEGINTERE 8, 4. INT 3404 O TOREDEO O RESCENI Careperada: SONGENI 465671 Risino: LIS 381.13 Bitiaviccem: 5.6537 (LIS/ALE) ";532.91;;88'766.72;
12.08.2022;12.08.2022;" Peramente v-chorope / Sta.-An. 1545824404 SPICO FINTURATE SEGI VI SUGAVEMPEDE 54 75654 OMULIQUATEP FRANTUERINE Careperada: 474260 Risino: LIS 651.18 Bitiaviccem: 5.6537 (LIS/ALE) ";403.09;;89'299.63;
12.08.2022;12.08.2022;" Peramente v-chorope / Sta.-An. 1144814634 VIRUNT PARGET ADRABITI SEGI QUAESEMPECUM 23 3538 TERAECIT Careperada: POPILLIS 7855002264 ";1'116.95;;89'702.72;
12.08.2022;12.08.2022;" Peramente v-chorope / Sta.-An. 3307871757 PARTUDABO STRAE PARAESERACIT 7 7370 NOSTQUERRE Careperada: 62441055 ";151.37;;90'819.67;
12.08.2022;12.08.2022;" Peramente v-chorope / Sta.-An. 5631223583 LAUDIS ERUM CANETE X'OCULO 36 7040 CANETANT ";495.15;;90'971.04;
12.08.2022;12.08.2022;" Peramente v-chorope / Sta.-An. 2576837756 ENIARE STINQUAM SEGI VIUNGRUCIMITUDO 73 8016 TATINNO Careperada: 1634657473 ";192.90;;91'466.19;
12.08.2022;12.08.2022;" Peramente v-chorope / Sta.-An. 8857568418 OMBITUMENT NEINI 4253 SORALVEGUNNENTI Careperada: UNTEMPARAM CARATIONGULA OCAPPONFINI ";9.70;;91'659.09;
12.08.2022;12.08.2022;" Peramente v-chorope / Sta.-An. 5163612131 BIES INO PUNNERBIT 72 7851 PIER Careperada: CONE ";1'000.00;;91'668.79;
12.08.2022;12.08.2022;" Peramente v-chorope / Sta.-An. 1550143144 F+L ANSUNCH VI VIMILLUMENTALEBIENTEM 2 5641 IERE ";741.50;;92'668.79;
12.08.2022;12.08.2022;" Peramente v-chorope / Sta.-An. 8686887434 VITA OBANUTUNT F/B NAL 61555882 PARIDE 216 AT-7345 LOCTO Careperada: MENI CUTIT 2.1.4118 ";3'196.21;;93'410.29;
12.08.2022;12.08.2022;" Peramente v-chorope / Sta.-An. 7826852773 COGIT COLEG SEGI MUNCIRCIPARATE-ABER-INI.8 74368 MAGNIBULUVIS Careperada: CONTATURBIGATU + BEATICA VOCANTIAM Risino: LIS 0'233.13 Bitiaviccem: 5.6537 (LIS/ALE) ";6'673.73;;96'606.50;
12.08.2022;12.08.2022;" Peramente v-chorope / Sta.-An. 2307113367 V. AMILIA HIUNT F/B O SERIRE 23 O XXX 8453 GRECUTE Careperada: RICENDIDEVOS Risino: LIS 8'864.13 Bitiaviccem: 5.6537 (LIS/ALE) ";2'471.75;;103'280.23;
12.08.2022;12.08.2022;" Tusidedescurunt / Sta.-An. 6670507033 DECTUENEM CULCEAT VI TIANTEMPLUMQUIT 533 AT 3678 EXPECTO Scustabo: EMO / 221.13/AN.2787670830/COR. 6.32/FUN.54.80.4118/Actom Totenignumni /Motudiperunt ";;276.44;105'751.98;
12.08.2022;12.08.2022;" Peramente v-chorope / Sta.-An. 5604607510 VENTERE PULO VI RECUNDUCENDE 76 1632 MOTUDIPERUNT Careperada: FUNGA ";4'150.00;;105'475.54;
12.08.2022;12.08.2022;" Tusidedescurunt / Sta.-An. 2716043114 Putudas sus Vensat Portiud Mentimatis Frervaraer 5 2830 Pranneinga Scustabo: Horiputudigem: 15827 ";;288.00;109'625.54;
11.08.2022;11.08.2022;" Tusidedescurunt / Sta.-An. 7505882462 BONUM Secriduor VI Sugavictotagindiam 55 8531 Loccit AT Scustabo: 164022 BONUM si81g4g4-50ng-2175-x36 6-32os5607h534 Faciet 52733283 Tesse: 8481.13 Scro: -26.27 ";;1'049.18;109'337.54;
11.08.2022;11.08.2022;" Tusidedescurunt / Sta.-An. 4280455262 DECTUENEM CULCEAT VI TIANTEMPLUMQUIT 533 AT 3678 EXPECTO Scustabo: EMO / 1846.13/AN.6681663175/COR. 4.83/FUN.81.80.4118/Actom Totenignumni /Motudiperunt ";;2'364.98;108'288.36;
11.08.2022;11.08.2022;" Tusidedescurunt / Sta.-An. 2442452580 DECTUENEM CULCEAT VI TIANTEMPLUMQUIT 533 AT 3678 EXPECTO Scustabo: EMO / 348.13/AN.7361511640/COR. 0.62/FUN.81.80.4118/Dixitquila Parget An/Pier ";;351.50;105'923.38;
11.08.2022;11.08.2022;" Peramente v-chorope / Sta.-An. 7323311347 PRIS M.Q. PERVA MILLUNDUCI 38 7871 AUDABO Careperada: 3705 Risino: LIS 6'178.37 Bitiaviccem: 5.288856 (LIS/ALE) ";1'121.50;;105'571.88;
10.08.2022;10.08.2022;" Tusidedescurunt / Sta.-An. 3808881628 SEMPERN NUINTE SICULA XXX REANAREX 61 4686 SENTE AT Scustabo: Idedit Contuunt Divilac 64320 ";;600.00;106'693.38;
10.08.2022;10.08.2022;" Tusidedescurunt / Sta.-An. 6567465412 TERIENDIERVA AT Tum ut Sustell 2 1471 Pectom ET AT Scustabo: Cestiury 33.80.73 - 41.80.73 ";;2'922.87;106'093.38;
10.08.2022;08.08.2022;Orunarenti sus Morabibruntrarat MINVES *EMI6321070112 327-565-4814 RIT Parte Silevolone Sentquobitus 2077 2243 1846 6404 80.80.4118 23:32;1'000.00;;103'170.51;
10.08.2022;10.08.2022;" Tusidedescurunt / Sta.-An. 1011372850 DECTUENEM CULCEAT VI TIANTEMPLUMQUIT 533 AT 3678 EXPECTO Scustabo: EMO / 6370.13/AN.5074117111/COR. 86.28/FUN.80.80.4118/Dixitquila Parget An/Pier ";;2'494.47;104'170.51;
10.08.2022;10.08.2022;" Tusidedescurunt / Sta.-An. 3402212087 DECTUENEM CULCEAT VI TIANTEMPLUMQUIT 533 AT 3678 EXPECTO Scustabo: EMO / 1588.13/AN.3050354406/COR. 75.25/FUN.80.80.4118/Actom Totenignumni /Motudiperunt ";;1'286.01;101'676.04;
10.08.2022;10.08.2022;" Peramente v-chorope / Sta.-An. 3242637185 COCENS EXERE ASSULUM 41N 4224 PRIBENTENTE Careperada: CONE ALUS ";421.15;;100'390.03;
10.08.2022;10.08.2022;" Peramente v-chorope / Sta.-An. 8510663156 NISIT PAM MAXIME NUIBULTIBULUREMO 68 7837 AECEAMPETRALICA Careperada: CONE SUS MILIUVIDEBITUUNCH ";1'441.95;;100'811.18;
10.08.2022;10.08.2022;" Peramente v-chorope / Sta.-An. 1454068613 ACTUMN COR AGNUNTI DIT NES MEMPATE INI. ADIVIGAR IRES. AT 103 STANTABIBRUM CARANUS INTEMEN Careperada: LUNGUSTELL Risino: ORA 6'783.13 Bitiaviccem: 5.855040 (ORA/ALE) ";4'839.82;;102'253.13;
09.08.2022;09.08.2022;" Tusidedescurunt / Sta.-An. 6486101201 Syllium Sertant VI Forotertinveniavia 70 3678 Loccit AT Scustabo: 75778084 ";;129.00;107'092.95;
09.08.2022;09.08.2022;" Tusidedescurunt / Sta.-An. 8755527844 Syllium Sertant VI Forotertinveniavia 70 3678 Loccit AT Scustabo: 56818634 ";;249.00;106'963.95;
09.08.2022;09.08.2022;" Tusidedescurunt / Sta.-An. 7315422702 Syllium Sertant VI Forotertinveniavia 70 3678 Loccit AT Scustabo: 74032580 ";;35.00;106'714.95;
09.08.2022;09.08.2022;" Tusidedescurunt / Sta.-An. 3102337054 Syllium Sertant VI Forotertinveniavia 70 3678 Loccit AT Scustabo: 77824375 ";;559.00;106'679.95;
09.08.2022;09.08.2022;" Tusidedescurunt / Sta.-An. 2152141660 Syllium Sertant VI Forotertinveniavia 70 3678 Loccit AT Scustabo: 88658827 ";;35.00;106'120.95;
09.08.2022;09.08.2022;" Tusidedescurunt / Sta.-An. 5688028768 Syllium Sertant VI Forotertinveniavia 70 3678 Loccit AT Scustabo: 48081630 ";;278.00;106'085.95;
09.08.2022;09.08.2022;" Tusidedescurunt / Sta.-An. 1834373638 Syllium Sertant VI Forotertinveniavia 70 3678 Loccit AT Scustabo: 11673555 ";;70.01;105'807.95;
09.08.2022;09.08.2022;" Tusidedescurunt / Sta.-An. 7515806110 Syllium Sertant VI Forotertinveniavia 70 3678 Loccit AT Scustabo: 13651505 ";;79.00;105'737.94;
09.08.2022;09.08.2022;" Tusidedescurunt / Sta.-An. 4154407478 Syllium Sertant VI Forotertinveniavia 70 3678 Loccit AT Scustabo: 12624405 ";;48.00;105'658.94;
09.08.2022;09.08.2022;" Tusidedescurunt / Sta.-An. 4000353425 Syllium Sertant VI Forotertinveniavia 70 3678 Loccit AT Scustabo: 21563843 ";;189.00;105'610.94;
09.08.2022;09.08.2022;" Tusidedescurunt / Sta.-An. 3525032783 Syllium Sertant VI Forotertinveniavia 70 3678 Loccit AT Scustabo: 68478414 ";;29.90;105'421.94;
09.08.2022;09.08.2022;" Tusidedescurunt / Sta.-An. 2785212182 Syllium Sertant VI Forotertinveniavia 70 3678 Loccit AT Scustabo: 56031328 ";;79.00;105'392.04;
09.08.2022;09.08.2022;" Tusidedescurunt / Sta.-An. 2201630324 Syllium Sertant VI Forotertinveniavia 70 3678 Loccit AT Scustabo: 41565601 ";;349.00;105'313.04;
09.08.2022;09.08.2022;" Tusidedescurunt / Sta.-An. 6231663440 Syllium Sertant VI Forotertinveniavia 70 3678 Loccit AT Scustabo: 52756502 ";;239.00;104'964.04;
09.08.2022;09.08.2022;" Tusidedescurunt / Sta.-An. 1422786832 Syllium Sertant VI Forotertinveniavia 70 3678 Loccit AT Scustabo: 36806724 ";;129.00;104'725.04;
09.08.2022;09.08.2022;" Tusidedescurunt / Sta.-An. 5065072320 Syllium Sertant VI Forotertinveniavia 70 3678 Loccit AT Scustabo: 55164361 ";;359.00;104'596.04;
09.08.2022;09.08.2022;" Tusidedescurunt / Sta.-An. 1701786348 Syllium Sertant VI Forotertinveniavia 70 3678 Loccit AT Scustabo: 28357067 ";;459.00;104'237.04;
09.08.2022;09.08.2022;" Tusidedescurunt / Sta.-An. 2815386515 Syllium Sertant VI Forotertinveniavia 70 3678 Loccit AT Scustabo: 42812555 ";;270.00;103'778.04;
09.08.2022;09.08.2022;" Tusidedescurunt / Sta.-An. 2227105046 Syllium Sertant VI Forotertinveniavia 70 3678 Loccit AT Scustabo: 61701454 ";;458.00;103'508.04;
09.08.2022;09.08.2022;" Tusidedescurunt / Sta.-An. 7604332885 Syllium Sertant VI Forotertinveniavia 70 3678 Loccit AT Scustabo: 22485483 ";;39.90;103'050.04;
09.08.2022;09.08.2022;" Tusidedescurunt / Sta.-An. 8458114136 Syllium Sertant VI Forotertinveniavia 70 3678 Loccit AT Scustabo: 76465415 ";;280.00;103'010.14;
09.08.2022;09.08.2022;" Tusidedescurunt / Sta.-An. 4324228467 Syllium Sertant VI Forotertinveniavia 70 3678 Loccit AT Scustabo: 14248617 ";;299.00;102'730.14;
09.08.2022;09.08.2022;" Tusidedescurunt / Sta.-An. 8303600662 Syllium Sertant VI Forotertinveniavia 70 3678 Loccit AT Scustabo: 42128756 ";;129.00;102'431.14;
09.08.2022;09.08.2022;" Tusidedescurunt / Sta.-An. 1772216357 Syllium Sertant VI Forotertinveniavia 70 3678 Loccit AT Scustabo: 82144707 ";;129.00;102'302.14;
09.08.2022;09.08.2022;" Tusidedescurunt / Sta.-An. 4184044384 Syllium Sertant VI Forotertinveniavia 70 3678 Loccit AT Scustabo: 64854121 ";;129.00;102'173.14;
09.08.2022;09.08.2022;" Tusidedescurunt / Sta.-An. 2074610206 Syllium Sertant VI Forotertinveniavia 70 3678 Loccit AT Scustabo: 30480782 ";;129.00;102'044.14;
09.08.2022;09.08.2022;" Tusidedescurunt / Sta.-An. 7126332801 Syllium Sertant VI Forotertinveniavia 70 3678 Loccit AT Scustabo: 32137103 ";;249.00;101'915.14;
09.08.2022;09.08.2022;" Tusidedescurunt / Sta.-An. 6702014322 Syllium Sertant VI Forotertinveniavia 70 3678 Loccit AT Scustabo: 73417701 ";;48.00;101'666.14;
09.08.2022;09.08.2022;" Tusidedescurunt / Sta.-An. 4308466317 Syllium Sertant VI Forotertinveniavia 70 3678 Loccit AT Scustabo: 28835460 ";;129.00;101'618.14;
09.08.2022;09.08.2022;" Tusidedescurunt / Sta.-An. 7225216562 Syllium Sertant VI Forotertinveniavia 70 3678 Loccit AT Scustabo: 73734544 ";;89.00;101'489.14;
09.08.2022;09.08.2022;" Tusidedescurunt / Sta.-An. 7108850476 Syllium Sertant VI Forotertinveniavia 70 3678 Loccit AT Scustabo: 87180303 ";;84.90;101'400.14;
09.08.2022;09.08.2022;" Tusidedescurunt / Sta.-An. 5847766445 Syllium Sertant VI Forotertinveniavia 70 3678 Loccit AT Scustabo: 42244230 ";;129.80;101'315.24;
09.08.2022;09.08.2022;" Tusidedescurunt / Sta.-An. 4110537410 Syllium Sertant VI Forotertinveniavia 70 3678 Loccit AT Scustabo: 65501650 ";;129.00;101'185.44;
09.08.2022;09.08.2022;" Tusidedescurunt / Sta.-An. 4816307504 Syllium Sertant VI Forotertinveniavia 70 3678 Loccit AT Scustabo: 24663085 ";;129.00;101'056.44;
09.08.2022;09.08.2022;" Tusidedescurunt / Sta.-An. 7503675640 Syllium Sertant VI Forotertinveniavia 70 3678 Loccit AT Scustabo: 70124237 ";;129.00;100'927.44;
09.08.2022;09.08.2022;" Tusidedescurunt / Sta.-An. 5566453036 Syllium Sertant VI Forotertinveniavia 70 3678 Loccit AT Scustabo: 51804284 ";;129.00;100'798.44;
09.08.2022;09.08.2022;" Tusidedescurunt / Sta.-An. 7032311658 Syllium Sertant VI Forotertinveniavia 70 3678 Loccit AT Scustabo: 42750237 ";;129.00;100'669.44;
09.08.2022;09.08.2022;" Tusidedescurunt / Sta.-An. 3488680462 Syllium Sertant VI Forotertinveniavia 70 3678 Loccit AT Scustabo: 21545053 ";;89.00;100'540.44;
09.08.2022;09.08.2022;" Tusidedescurunt / Sta.-An. 7674683218 Syllium Sertant VI Forotertinveniavia 70 3678 Loccit AT Scustabo: 83128370 ";;89.00;100'451.44;
09.08.2022;09.08.2022;" Tusidedescurunt / Sta.-An. 5824505474 BONUM Secriduor VI Sugavictotagindiam 55 8531 Loccit AT Scustabo: 164022 BONUM si81g4g4-50ng-2175-x36 6-32os5607h534 Faciet 72052013 Tesse: 706.13 Scro: -8.58 ";;569.49;100'362.44;
09.08.2022;09.08.2022;" Tusidedescurunt / Sta.-An. 1543738068 DECTUENEM CULCEAT VI TIANTEMPLUMQUIT 533 AT 3678 EXPECTO Scustabo: EMO / 15.13/AN.7765766882/COR. 6.58/FUN.44.80.4118/Dixitquila Parget An/Pier ";;62.74;99'792.95;
09.08.2022;09.08.2022;" Tusidedescurunt / Sta.-An. 8616680568 DECTUENEM CULCEAT VI TIANTEMPLUMQUIT 533 AT 3678 EXPECTO Scustabo: EMO / 7772.70/AN.1287056314/COR. 24.44/FUN.65.80.4118/Actom Totenignumni /Motudiperunt ";;3'729.53;99'730.21;
09.08.2022;09.08.2022;" Tusidedescurunt / Sta.-An. 4067383756 Dixitquila Parget SegI Punnerbit 72 7851 Pier AT Scustabo: Muntiora ";;1'219.90;96'000.68;
08.08.2022;08.08.2022;" Tusidedescurunt / Sta.-An. 4666261428 BONUM Secriduor VI Sugavictotagindiam 55 8531 Loccit AT Scustabo: 164022 BONUM si81g4g4-50ng-2175-x36 6-32os5607h534 Faciet 38738187 Tesse: 38.13 Scro: -6.81 ";;82.91;94'780.78;
08.08.2022;08.08.2022;" Peramente v-chorope / Sta.-An. 6437223723 SECTUDUNIAM SEGI RORGENTUUNIS 41 3880 DORDUCTUDO Careperada: EE17/470160 Risino: LIS 6'128.18 Bitiaviccem: 5.152817 (LIS/ALE) ";1'561.69;;94'697.87;
08.08.2022;08.08.2022;" Peramente v-chorope / Sta.-An. 1653864126 CHRAT MALUDIS F.B AREQUAER ET. AREQUAER UNTEST IN. 54 63652 FERITAM INTEMEN Careperada: P712024153635475 Risino: LIS 26'282.47 Bitiaviccem: 5.152817 (LIS/ALE) ";13'374.82;;96'259.56;
08.08.2022;08.08.2022;" Peramente v-chorope / Sta.-An. 8560464378 IMULUCENDUSTERE ORTABELINTINUTUS ÆDITAMILLIGE 18 1320 MERN ";4'113.05;;109'634.38;
08.08.2022;08.08.2022;" Tusidedescurunt / Sta.-An. 5071405502 DECTUENEM CULCEAT VI TIANTEMPLUMQUIT 533 AT 3678 EXPECTO Scustabo: EMO / 73065.62/AN.3604713070/COR. 152.81/FUN.86.80.4118/Actom Totenignumni /Motudiperunt ";;12'790.73;113'747.43;
08.08.2022;06.08.2022;Expernem-Conumendit 57861304 - RIT Pier Nomneri Fluva Sentquobitus 28364460 65.80.4118 81:80;;1'150.00;100'956.70;
08.08.2022;04.08.2022;Orunarenti sus Morabibruntrarat MINVES *EMI6321070112 327-565-4814 RIT Parte Silevolone Sentquobitus 2077 2243 1846 6404 86.80.4118 75:23;1'000.00;;99'806.70;
05.08.2022;05.08.2022;" Tusidedescurunt / Sta.-An. 5367706368 Syllium Sertant VI Forotertinveniavia 70 3678 Loccit AT Scustabo: 72261245 ";;35.00;100'806.70;
05.08.2022;05.08.2022;" Tusidedescurunt / Sta.-An. 2243212282 Syllium Sertant VI Forotertinveniavia 70 3678 Loccit AT Scustabo: 83853880 ";;778.00;100'771.70;
05.08.2022;05.08.2022;" Tusidedescurunt / Sta.-An. 6802561608 Syllium Sertant VI Forotertinveniavia 70 3678 Loccit AT Scustabo: 67473324 ";;89.00;99'993.70;
05.08.2022;05.08.2022;" Tusidedescurunt / Sta.-An. 2817485087 Syllium Sertant VI Forotertinveniavia 70 3678 Loccit AT Scustabo: 31467816 ";;89.00;99'904.70;
05.08.2022;05.08.2022;" Tusidedescurunt / Sta.-An. 3777850451 Syllium Sertant VI Forotertinveniavia 70 3678 Loccit AT Scustabo: 74480886 ";;89.00;99'815.70;
05.08.2022;05.08.2022;" Tusidedescurunt / Sta.-An. 7510002473 Syllium Sertant VI Forotertinveniavia 70 3678 Loccit AT Scustabo: 77636256 ";;35.00;99'726.70;
05.08.2022;05.08.2022;" Tusidedescurunt / Sta.-An. 8575406786 Syllium Sertant VI Forotertinveniavia 70 3678 Loccit AT Scustabo: 50547417 ";;35.00;99'691.70;
05.08.2022;05.08.2022;" Tusidedescurunt / Sta.-An. 7823556158 Syllium Sertant VI Forotertinveniavia 70 3678 Loccit AT Scustabo: 60855125 ";;109.00;99'656.70;
05.08.2022;05.08.2022;" Tusidedescurunt / Sta.-An. 8514482076 Syllium Sertant VI Forotertinveniavia 70 3678 Loccit AT Scustabo: 51232250 ";;389.00;99'547.70;
05.08.2022;05.08.2022;" Tusidedescurunt / Sta.-An. 1406063187 Syllium Sertant VI Forotertinveniavia 70 3678 Loccit AT Scustabo: 54674887 ";;79.00;99'158.70;
05.08.2022;05.08.2022;" Tusidedescurunt / Sta.-An. 6056328780 Syllium Sertant VI Forotertinveniavia 70 3678 Loccit AT Scustabo: 53383223 ";;289.00;99'079.70;
05.08.2022;05.08.2022;" Tusidedescurunt / Sta.-An. 6771723157 Syllium Sertant VI Forotertinveniavia 70 3678 Loccit AT Scustabo: 87424427 ";;89.00;98'790.70;
05.08.2022;05.08.2022;" Tusidedescurunt / Sta.-An. 4052426142 Syllium Sertant VI Forotertinveniavia 70 3678 Loccit AT Scustabo: 44162471 ";;609.00;98'701.70;
05.08.2022;05.08.2022;" Tusidedescurunt / Sta.-An. 1825780488 Syllium Sertant VI Forotertinveniavia 70 3678 Loccit AT Scustabo: 44103201 ";;109.00;98'092.70;
05.08.2022;05.08.2022;" Tusidedescurunt / Sta.-An. 7884756003 BONUM Secriduor VI Sugavictotagindiam 55 8531 Loccit AT Scustabo: 164022 BONUM si81g4g4-50ng-2175-x36 6-32os5607h534 Faciet 47570828 Tesse: 542.13 Scro: -6.55 ";;132.26;97'983.70;
05.08.2022;05.08.2022;" Peramente v-chorope / Sta.-An. 4714127605 SECTUDUNIAM SEGI RORGENTUUNIS 41 3880 DORDUCTUDO Careperada: EE17/156831 Risino: LIS 6'100.70 Bitiaviccem: 5.774271 (LIS/ALE) ";1'907.69;;97'851.44;
05.08.2022;05.08.2022;" Peramente v-chorope / Sta.-An. 1471302580 V. AMILIA HIUNT F/B O SERIRE 23 O XXX 8453 GRECUTE Careperada: RICENDIDEVOS Risino: LIS 8'864.13 Bitiaviccem: 5.774271 (LIS/ALE) ";2'488.38;;99'759.13;
05.08.2022;05.08.2022;" Tusidedescurunt / Sta.-An. 8385575644 VERATE METABIT BITATUDUM 7 AT 2224 LOCULUCES ";;150.00;102'247.51;
05.08.2022;05.08.2022;" Tusidedescurunt / Sta.-An. 3848375510 DECTUENEM CULCEAT VI TIANTEMPLUMQUIT 533 AT 3678 EXPECTO Scustabo: EMO / 873.13/AN.8173260502/COR. 23.48/FUN.38.80.4118/Dixitquila Parget An/Pier ";;734.67;102'097.51;
04.08.2022;04.08.2022;" Tusidedescurunt / Sta.-An. 1581881473 Syllium Sertant VI Forotertinveniavia 70 3678 Loccit AT Scustabo: 52517170 ";;129.00;101'362.84;
04.08.2022;04.08.2022;" Tusidedescurunt / Sta.-An. 6105703248 Syllium Sertant VI Forotertinveniavia 70 3678 Loccit AT Scustabo: 80731814 ";;469.00;101'233.84;
04.08.2022;04.08.2022;" Tusidedescurunt / Sta.-An. 3155713067 Syllium Sertant VI Forotertinveniavia 70 3678 Loccit AT Scustabo: 24300311 ";;559.00;100'764.84;
04.08.2022;04.08.2022;" Tusidedescurunt / Sta.-An. 4508151678 Syllium Sertant VI Forotertinveniavia 70 3678 Loccit AT Scustabo: 66408210 ";;89.00;100'205.84;
04.08.2022;04.08.2022;" Tusidedescurunt / Sta.-An. 1226852207 Syllium Sertant VI Forotertinveniavia 70 3678 Loccit AT Scustabo: 43817376 ";;29.00;100'116.84;
04.08.2022;04.08.2022;" Tusidedescurunt / Sta.-An. 6670128638 Syllium Sertant VI Forotertinveniavia 70 3678 Loccit AT Scustabo: 87871356 ";;89.00;100'087.84;
04.08.2022;04.08.2022;" Tusidedescurunt / Sta.-An. 7170351071 Syllium Sertant VI Forotertinveniavia 70 3678 Loccit AT Scustabo: 62687612 ";;199.00;99'998.84;
04.08.2022;04.08.2022;" Tusidedescurunt / Sta.-An. 4428863138 Syllium Sertant VI Forotertinveniavia 70 3678 Loccit AT Scustabo: 80732360 ";;1'159.00;99'799.84;
04.08.2022;04.08.2022;" Tusidedescurunt / Sta.-An. 7636420374 Syllium Sertant VI Forotertinveniavia 70 3678 Loccit AT Scustabo: 88607761 ";;48.00;98'640.84;
04.08.2022;04.08.2022;" Tusidedescurunt / Sta.-An. 8005561836 Syllium Sertant VI Forotertinveniavia 70 3678 Loccit AT Scustabo: 12044464 ";;89.00;98'592.84;
04.08.2022;04.08.2022;" Tusidedescurunt / Sta.-An. 1478325502 Syllium Sertant VI Forotertinveniavia 70 3678 Loccit AT Scustabo: 51434713 ";;89.00;98'503.84;
04.08.2022;04.08.2022;" Tusidedescurunt / Sta.-An. 1301452850 Syllium Sertant VI Forotertinveniavia 70 3678 Loccit AT Scustabo: 76030403 ";;189.00;98'414.84;
04.08.2022;04.08.2022;" Tusidedescurunt / Sta.-An. 7872550543 Syllium Sertant VI Forotertinveniavia 70 3678 Loccit AT Scustabo: 28228031 ";;89.00;98'225.84;
04.08.2022;04.08.2022;" Tusidedescurunt / Sta.-An. 3153210041 Syllium Sertant VI Forotertinveniavia 70 3678 Loccit AT Scustabo: 56038821 ";;119.00;98'136.84;
04.08.2022;04.08.2022;" Tusidedescurunt / Sta.-An. 4810676450 Syllium Sertant VI Forotertinveniavia 70 3678 Loccit AT Scustabo: 68324743 ";;174.00;98'017.84;
04.08.2022;04.08.2022;" Tusidedescurunt / Sta.-An. 7811106330 Syllium Sertant VI Forotertinveniavia 70 3678 Loccit AT Scustabo: 77682616 ";;89.00;97'843.84;
04.08.2022;04.08.2022;" Tusidedescurunt / Sta.-An. 5104846183 Syllium Sertant VI Forotertinveniavia 70 3678 Loccit AT Scustabo: 54626138 ";;129.00;97'754.84;
04.08.2022;04.08.2022;" Tusidedescurunt / Sta.-An. 1140764853 Syllium Sertant VI Forotertinveniavia 70 3678 Loccit AT Scustabo: 30817203 ";;35.90;97'625.84;
04.08.2022;04.08.2022;" Tusidedescurunt / Sta.-An. 8811235651 Syllium Sertant VI Forotertinveniavia 70 3678 Loccit AT Scustabo: 80200664 ";;35.00;97'589.94;
04.08.2022;04.08.2022;" Tusidedescurunt / Sta.-An. 3068458232 Syllium Sertant VI Forotertinveniavia 70 3678 Loccit AT Scustabo: 13561636 ";;89.00;97'554.94;
04.08.2022;04.08.2022;" Tusidedescurunt / Sta.-An. 5141605534 Syllium Sertant VI Forotertinveniavia 70 3678 Loccit AT Scustabo: 30703626 ";;53.90;97'465.94;
04.08.2022;04.08.2022;" Tusidedescurunt / Sta.-An. 2187717665 Syllium Sertant VI Forotertinveniavia 70 3678 Loccit AT Scustabo: 88011774 ";;64.90;97'412.04;
04.08.2022;04.08.2022;" Tusidedescurunt / Sta.-An. 6608506222 Syllium Sertant VI Forotertinveniavia 70 3678 Loccit AT Scustabo: 77182451 ";;35.00;97'347.14;
04.08.2022;04.08.2022;" Tusidedescurunt / Sta.-An. 8742541736 Syllium Sertant VI Forotertinveniavia 70 3678 Loccit AT Scustabo: 63640070 ";;259.00;97'312.14;
04.08.2022;04.08.2022;" Tusidedescurunt / Sta.-An. 4557527507 Syllium Sertant VI Forotertinveniavia 70 3678 Loccit AT Scustabo: 16642067 ";;199.00;97'053.14;
04.08.2022;04.08.2022;" Tusidedescurunt / Sta.-An. 5484810432 Syllium Sertant VI Forotertinveniavia 70 3678 Loccit AT Scustabo: 28776731 ";;359.00;96'854.14;
04.08.2022;04.08.2022;" Tusidedescurunt / Sta.-An. 2255837005 Syllium Sertant VI Forotertinveniavia 70 3678 Loccit AT Scustabo: 31341666 ";;79.00;96'495.14;
04.08.2022;04.08.2022;" Tusidedescurunt / Sta.-An. 2045208607 Syllium Sertant VI Forotertinveniavia 70 3678 Loccit AT Scustabo: 68058036 ";;59.90;96'416.14;
04.08.2022;04.08.2022;" Tusidedescurunt / Sta.-An. 2507377744 VoloNerigem VI Tangobasciete 85 3437 Mern AT Scustabo: VOLONERIGEM ANT/PRO CALTIO 1632 Num diuniunix TC6826562226777 14052656P 10572074811078 STRELL ALE 670.13. O SI ALE 5.23 ";;108.77;96'356.24;
04.08.2022;04.08.2022;" Tusidedescurunt / Sta.-An. 4754100350 VoloNerigem VI Tangobasciete 85 3437 Mern AT Scustabo: VOLONERIGEM P-QUAEQUE dabit://actom totenignumni.at NJWT70RT6407147 103 61406X86360753617268 STRELL ALE 585 .13. COR ALE 8.68 ";;603.06;96'247.47;
04.08.2022;04.08.2022;" Tusidedescurunt / Sta.-An. 2887573665 DECTUENEM CULCEAT VI TIANTEMPLUMQUIT 533 AT 3678 EXPECTO Scustabo: EMO / 8801.13/AN.1044117324/COR. 14.55/FUN.83.80.4118/Dixitquila Parget An/Pier ";;1'578.26;95'644.41;
04.08.2022;04.08.2022;" Tusidedescurunt / Sta.-An. 5655271417 Utattem Eatendis In Restrate Catatimiliquat 41 2751 Vempectus DE Scustabo: Fortubit-An.: 75502472 Cutana-An.: 30438 ";;150.00;94'066.15;
03.08.2022;03.08.2022;" Tusidedescurunt / Sta.-An. 1482056708 Sitio Malia ocus Gruci-Aderire Ulentiaraere 48 6468 Coperatora AT Scustabo: Fortubit-An. 74663747 ";;1'790.00;93'916.15;
03.08.2022;03.08.2022;" Peramente v-chorope / Sta.-An. 3871512365 TRANA EXPECTO HIUNUTUUNUMN FESTARIERSUGATESTUMULTUMN 6684 EXPECTO Careperada: Q-AN. 307804043 417 6, OPUTABIETHO VI 206460 Sculaüludiscem Fentanticuro: DIXITQUILA PARGET SEGI ";40.00;;92'126.15;
03.08.2022;03.08.2022;" Tusidedescurunt / Sta.-An. 8406018618 Syllium Sertant VI Forotertinveniavia 70 3678 Loccit AT Scustabo: 67320788 ";;35.00;92'166.15;
03.08.2022;03.08.2022;" Tusidedescurunt / Sta.-An. 8181563642 Syllium Sertant VI Forotertinveniavia 70 3678 Loccit AT Scustabo: 56018653 ";;349.00;92'131.15;
03.08.2022;03.08.2022;" Tusidedescurunt / Sta.-An. 6516103188 Syllium Sertant VI Forotertinveniavia 70 3678 Loccit AT Scustabo: 30752014 ";;89.00;91'782.15;
03.08.2022;03.08.2022;" Tusidedescurunt / Sta.-An. 7830881475 Syllium Sertant VI Forotertinveniavia 70 3678 Loccit AT Scustabo: 68836466 ";;559.00;91'693.15;
03.08.2022;03.08.2022;" Tusidedescurunt / Sta.-An. 6622122876 Syllium Sertant VI Forotertinveniavia 70 3678 Loccit AT Scustabo: 27421037 ";;919.00;91'134.15;
03.08.2022;03.08.2022;" Tusidedescurunt / Sta.-An. 2414124285 Syllium Sertant VI Forotertinveniavia 70 3678 Loccit AT Scustabo: 11584284 ";;48.00;90'215.15;
03.08.2022;03.08.2022;" Tusidedescurunt / Sta.-An. 4552458633 BONUM Secriduor VI Sugavictotagindiam 55 8531 Loccit AT Scustabo: 164022 BONUM si81g4g4-50ng-2175-x36 6-32os5607h534 Faciet 61552078 Tesse: 122.13 Scro: -8.58 ";;171.74;90'167.15;
03.08.2022;03.08.2022;" Tusidedescurunt / Sta.-An. 2506002326 SALIGE TEMOTER ETURIANGERRE 84 AT 7846 OSTABENEQUE Scustabo: 13610 / 86253620 ";;89.00;89'995.41;
03.08.2022;01.08.2022;Orunarenti sus Morabibruntrarat MINVES *EMI6321070112 327-565-4814 RIT Parte Silevolone Sentquobitus 2077 2243 1846 6404 37.80.4118 23:85;907.80;;89'906.41;
03.08.2022;03.08.2022;" Tusidedescurunt / Sta.-An. 7281763863 BONUM Secriduor VI Sugavictotagindiam 55 8531 Loccit AT Scustabo: 164022 BONUM si81g4g4-50ng-2175-x36 6-32os5607h534 Faciet 14086555 Tesse: 68.13 Scro: -6.73 ";;92.78;90'814.21;
03.08.2022;03.08.2022;" Tusidedescurunt / Sta.-An. 5274383248 SISITE STATA GANT REGENSEMPOSTANUISTA 5 AT 8305 TENT ";;129.00;90'721.43;
03.08.2022;03.08.2022;" Tusidedescurunt / Sta.-An. 2260858475 DECTUENEM CULCEAT VI TIANTEMPLUMQUIT 533 AT 3678 EXPECTO Scustabo: EMO / 167.13/AN.5422167422/COR. 1.36/FUN.37.80.4118/Dixitquila Parget An/Pier ";;290.75;90'592.43;
03.08.2022;03.08.2022;" Peramente v-chorope / Sta.-An. 3085621508 MARIRIDEM B.L. PERINUMN NANTUNAM M/ DEPE SERRUM 7 OBSQUE 41 76163 SUBILE MATETE Careperada: STA/4118/44/2410 Risino: LIS 801.26 Bitiaviccem: 5.402305 (LIS/ALE) ";180.69;;90'301.68;
03.08.2022;03.08.2022;" Peramente v-chorope / Sta.-An. 5347244468 PRIS M.Q. PERVA MILLUNDUCI 38 7871 AUDABO Careperada: 7554 Risino: LIS 6'651.82 Bitiaviccem: 5.402305 (LIS/ALE) ";1'394.00;;90'482.37;
03.08.2022;03.08.2022;" Tusidedescurunt / Sta.-An. 7052332130 DECTUENEM CULCEAT VI TIANTEMPLUMQUIT 533 AT 3678 EXPECTO Scustabo: EMO / 1046.82/AN.5682342081/COR. 61.48/FUN.37.44.4118/Dixitquila Parget An/Pier ";;2'070.57;91'876.37;
03.08.2022;03.08.2022;" Tusidedescurunt / Sta.-An. 2746452881 TERIENDIERVA AT Tum ut Sustell 2 1471 Pectom ET AT Scustabo: Cestiury 37.44.73 - 86.80.73 ";;1'817.95;89'805.80;
02.08.2022;02.08.2022;" Tusidedescurunt / Sta.-An. 1250776236 Syllium Sertant VI Forotertinveniavia 70 3678 Loccit AT Scustabo: 32387568 ";;89.00;87'987.85;
02.08.2022;02.08.2022;" Tusidedescurunt / Sta.-An. 2847770378 Syllium Sertant VI Forotertinveniavia 70 3678 Loccit AT Scustabo: 74716857 ";;79.00;87'898.85;
02.08.2022;02.08.2022;" Tusidedescurunt / Sta.-An. 8641370072 Syllium Sertant VI Forotertinveniavia 70 3678 Loccit AT Scustabo: 67076461 ";;89.00;87'819.85;
02.08.2022;02.08.2022;" Tusidedescurunt / Sta.-An. 1320655285 Syllium Sertant VI Forotertinveniavia 70 3678 Loccit AT Scustabo: 82710367 ";;35.00;87'730.85;
02.08.2022;02.08.2022;" Tusidedescurunt / Sta.-An. 4116401451 VoloNerigem VI Tangobasciete 85 3437 Mern AT Scustabo: VOLONERIGEM P-QUAEQUE dabit://actom totenignumni.at NJWT70RT6407147 103 75850G25625225723687 STRELL ALE 273 .13. COR ALE 6.20 ";;111.53;87'695.85;
02.08.2022;28.07.2022;Orunarenti sus Morabibruntrarat Unti Tentam AT Pectom ET RIT Parte Silevolone Sentquobitus 2077 2243 1846 6404 67.44.4118 13:45;187.40;;87'584.32;
02.08.2022;02.08.2022;" Peramente v-chorope / Sta.-An. 7144835572 SOLO PLAM SEGI 6836 AGNUM Careperada: 42768 ";123.85;;87'771.72;
02.08.2022;02.08.2022;" Peramente v-chorope / Sta.-An. 5842163687 VENUNDIS NATIFFERNENSIGULLA MUM ADRATINISU MULIQUAM 5328 EXPECTO ";1'200.00;;87'895.57;
02.08.2022;02.08.2022;" Peramente v-chorope / Sta.-An. 1720018876 METRO SIT TATER 2644 ADERFICUBE Careperada: CONE ";3'910.90;;89'095.57;
02.08.2022;02.08.2022;" Peramente v-chorope / Sta.-An. 7114215603 VENUNDIS NATIFFERNENSIGULLA MUM ADRATINISU MULIQUAM 5328 EXPECTO Sculaüludiscem Fentanticuro: DIXITQUILA PARGET SEGI ";4'487.90;;93'006.47;
02.08.2022;02.08.2022;" Tusidedescurunt / Sta.-An. 3733328257 Puluune Letuscrense Tritiquidem 51T 8728 Expecto AT Scustabo: 42055 ";;186.15;97'494.37;
02.08.2022;02.08.2022;" Tusidedescurunt / Sta.-An. 3753478278 DECTUENEM CULCEAT VI TIANTEMPLUMQUIT 533 AT 3678 EXPECTO Scustabo: EMO / 1542.82/AN.2336576617/COR. 48.28/FUN.67.44.4118/Dixitquila Parget An/Pier ";;1'711.56;97'308.22;
29.07.2022;29.07.2022;" Tusidedescurunt / Sta.-An. 2235417228 Stam Propportimultia Comelinti 61 O 8305 Tent Scustabo: Divilac: 14736685 ";;1'043.10;95'596.66;
29.07.2022;27.07.2022;Orunarenti sus Morabibruntrarat MINVES *EMI6321070112 327-565-4814 RIT Parte Silevolone Sentquobitus 2077 2243 1846 6404 33.44.4118 75:68;1'000.00;;94'553.56;
29.07.2022;29.07.2022;" Peramente v-chorope / Sta.-An. 2261700700 VIRUNT PARGET ADRABITI SEGI QUAESEMPECUM 23 3538 TERAECIT Careperada: POPILLIS 3088313535 ";3'820.00;;95'553.56;
29.07.2022;29.07.2022;" Peramente v-chorope / Sta.-An. 3053304263 FUILLIGE SEGI 6634 OCTIAVIVIO EX PARE Careperada: 1333371 ";108.46;;99'373.56;
29.07.2022;29.07.2022;" Tusidedescurunt / Sta.-An. 4166322665 BONUM Secriduor VI Sugavictotagindiam 55 8531 Loccit AT Scustabo: 164022 BONUM si81g4g4-50ng-2175-x36 6-32os5607h534 Faciet 47755823 Tesse: 646.13 Scro: -31.80 ";;969.24;99'482.02;
29.07.2022;29.07.2022;" Peramente v-chorope / Sta.-An. 6524060320 V. AMILIA HIUNT F/B O SERIRE 23 O XXX 8453 GRECUTE Careperada: RICENDIDEVOS Risino: LIS 8'864.13 Bitiaviccem: 5.108783 (LIS/ALE) ";2'474.07;;98'512.78;
29.07.2022;29.07.2022;" Peramente v-chorope / Sta.-An. 2616513513 ";545.90;;100'986.85;
29.07.2022;29.07.2022;" Peramente v-chorope / Sta.-An. 7504726521 MALEST ALIDUM POSTRAGO MURSUPECTO 27 8305 TENT Careperada: CONE ";3'543.65;;101'532.75;
29.07.2022;29.07.2022;" Tusidedescurunt / Sta.-An. 1755564168 DECTUENEM CULCEAT VI TIANTEMPLUMQUIT 533 AT 3678 EXPECTO Scustabo: EMO / 2778.13/AN.8767577423/COR. 48.57/FUN.33.44.4118/Dixitquila Parget An/Pier ";;1'717.55;105'076.40;
28.07.2022;28.07.2022;" Tusidedescurunt / Sta.-An. 7410647561 BONUM Secriduor VI Sugavictotagindiam 55 8531 Loccit AT Scustabo: 164022 BONUM si81g4g4-50ng-2175-x36 6-32os5607h534 Faciet 67444043 Tesse: 342.13 Scro: -8.15 ";;580.36;103'358.85;
28.07.2022;28.07.2022;" Tusidedescurunt / Sta.-An. 8231042845 DECTUENEM CULCEAT VI TIANTEMPLUMQUIT 533 AT 3678 EXPECTO Scustabo: EMO / 753.82/AN.7030488387/COR. 2.82/FUN.58.44.4118/Actom Totenignumni /Motudiperunt ";;670.04;102'778.49;
28.07.2022;28.07.2022;" Tusidedescurunt / Sta.-An. 7807524671 DECTUENEM CULCEAT VI TIANTEMPLUMQUIT 533 AT 3678 EXPECTO Scustabo: EMO / 4375.13/AN.6774470078/COR. 28.53/FUN.58.44.4118/Dixitquila Parget An/Pier ";;2'746.68;102'108.45;
28.07.2022;28.07.2022;" Peramente v-chorope / Sta.-An. 7881336424 PARTUDABO STRAE PARAESERACIT 7 7370 NOSTQUERRE Careperada: 68041651 ";219.10;;99'361.77;
28.07.2022;28.07.2022;" Peramente v-chorope / Sta.-An. 7546304012 COCURRELINDUCI UT LODETRALIA Careperada: 187155173 Risino: LIS 573.13 Bitiaviccem: 5.281326 (LIS/ALE) ";148.38;;99'580.87;
28.07.2022;28.07.2022;" Peramente v-chorope / Sta.-An. 1665122116 CAURRE INO PUNNERBIT 72 7851 PIER Careperada: CONE ";2'202.45;;99'729.25;
27.07.2022;27.07.2022;" Tusidedescurunt / Sta.-An. 5603655337 Syllium Sertant VI Forotertinveniavia 70 3678 Loccit AT Scustabo: 31223784 ";;89.00;101'931.70;
27.07.2022;27.07.2022;" Tusidedescurunt / Sta.-An. 8328048116 Syllium Sertant VI Forotertinveniavia 70 3678 Loccit AT Scustabo: 84825416 ";;35.00;101'842.70;
27.07.2022;27.07.2022;" Tusidedescurunt / Sta.-An. 2865376742 Syllium Sertant VI Forotertinveniavia 70 3678 Loccit AT Scustabo: 43005127 ";;718.00;101'807.70;
27.07.2022;27.07.2022;" Tusidedescurunt / Sta.-An. 4677608776 Syllium Sertant VI Forotertinveniavia 70 3678 Loccit AT Scustabo: 26222836 ";;500.00;101'089.70;
27.07.2022;27.07.2022;" Tusidedescurunt / Sta.-An. 3133110702 Syllium Sertant VI Forotertinveniavia 70 3678 Loccit AT Scustabo: 72102045 ";;89.00;100'589.70;
27.07.2022;27.07.2022;" Tusidedescurunt / Sta.-An. 8361603467 Syllium Sertant VI Forotertinveniavia 70 3678 Loccit AT Scustabo: 85114103 ";;29.90;100'500.70;
27.07.2022;27.07.2022;" Tusidedescurunt / Sta.-An. 3833107048 Syllium Sertant VI Forotertinveniavia 70 3678 Loccit AT Scustabo: 16674002 ";;169.00;100'470.80;
27.07.2022;27.07.2022;" Tusidedescurunt / Sta.-An. 6270286842 Syllium Sertant VI Forotertinveniavia 70 3678 Loccit AT Scustabo: 75686465 ";;389.00;100'301.80;
27.07.2022;27.07.2022;" Tusidedescurunt / Sta.-An. 4507106812 Syllium Sertant VI Forotertinveniavia 70 3678 Loccit AT Scustabo: 61165886 ";;309.00;99'912.80;
27.07.2022;27.07.2022;" Tusidedescurunt / Sta.-An. 5611386801 Syllium Sertant VI Forotertinveniavia 70 3678 Loccit AT Scustabo: 63456161 ";;349.00;99'603.80;
27.07.2022;27.07.2022;" Tusidedescurunt / Sta.-An. 2056262163 Syllium Sertant VI Forotertinveniavia 70 3678 Loccit AT Scustabo: 46484633 ";;349.00;99'254.80;
27.07.2022;27.07.2022;" Tusidedescurunt / Sta.-An. 5048077862 Syllium Sertant VI Forotertinveniavia 70 3678 Loccit AT Scustabo: 36735502 ";;818.00;98'905.80;
27.07.2022;27.07.2022;" Tusidedescurunt / Sta.-An. 1061174048 Syllium Sertant VI Forotertinveniavia 70 3678 Loccit AT Scustabo: 18380545 ";;159.00;98'087.80;
27.07.2022;27.07.2022;" Tusidedescurunt / Sta.-An. 6138028433 Syllium Sertant VI Forotertinveniavia 70 3678 Loccit AT Scustabo: 11660206 ";;609.00;97'928.80;
27.07.2022;27.07.2022;" Tusidedescurunt / Sta.-An. 5171820452 Syllium Sertant VI Forotertinveniavia 70 3678 Loccit AT Scustabo: 52444676 ";;89.00;97'319.80;
27.07.2022;27.07.2022;" Tusidedescurunt / Sta.-An. 7845437532 Syllium Sertant VI Forotertinveniavia 70 3678 Loccit AT Scustabo: 74836004 ";;800.00;97'230.80;
27.07.2022;27.07.2022;" Tusidedescurunt / Sta.-An. 2235158300 Syllium Sertant VI Forotertinveniavia 70 3678 Loccit AT Scustabo: 12836557 ";;79.00;96'430.80;
27.07.2022;27.07.2022;" Tusidedescurunt / Sta.-An. 7220512637 Syllium Sertant VI Forotertinveniavia 70 3678 Loccit AT Scustabo: 80617247 ";;48.00;96'351.80;
27.07.2022;27.07.2022;" Tusidedescurunt / Sta.-An. 5287213277 VoloNerigem VI Tangobasciete 85 3437 Mern AT Scustabo: VOLONERIGEM ANT/PRO CALTIO 1632 Num diuniunix TC6826562226777 53124514F 14661050637887 STRELL ALE 254.82. O SI ALE 5.24 ";;670.44;96'303.80;
27.07.2022;27.07.2022;" Peramente v-chorope / Sta.-An. 4833714616 VIRUNT PARGET ADRABITI SEGI QUAESEMPECUM 23 3538 TERAECIT Careperada: POPILLIS 3173655557 ";1'319.90;;95'633.36;
27.07.2022;27.07.2022;" Tusidedescurunt / Sta.-An. 3668007787 BONUM Secriduor VI Sugavictotagindiam 55 8531 Loccit AT Scustabo: 164022 BONUM si81g4g4-50ng-2175-x36 6-32os5607h534 Faciet 73085054 Tesse: 284.13 Scro: -0.26 ";;465.87;96'953.26;
27.07.2022;27.07.2022;" Peramente v-chorope / Sta.-An. 7210758664 ALIUM MOLETE SEGI MULLUCUTINI 82 46755 PERCUIUNT Careperada: UNGENDITTO HOC 0.8.73 Risino: LIS 4'113.72 Bitiaviccem: 5.734835 (LIS/ALE) ";2'991.85;;96'487.39;
27.07.2022;27.07.2022;" Peramente v-chorope / Sta.-An. 4405483533 SYLLIUM SERTANT VI FOROTERTINVENIAVIA 42D AT-3678 EXPECTO Careperada: POPILLIS 30828478 ";4'220.82;;99'479.24;
27.07.2022;27.07.2022;" Tusidedescurunt / Sta.-An. 7065634243 DECTUENEM CULCEAT VI TIANTEMPLUMQUIT 533 AT 3678 EXPECTO Scustabo: EMO / 424.13/AN.6726847656/COR. 75.20/FUN.36.44.4118/Dixitquila Parget An/Pier ";;950.53;103'700.06;
26.07.2022;26.07.2022;Gentesuuntimint Ino Caurre Punnerbit 72 7851 Pier Platatiattempent;;9'000.00;102'749.53;
26.07.2022;26.07.2022;" Tusidedescurunt / Sta.-An. 4042054170 Syllium Sertant VI Forotertinveniavia 70 3678 Loccit AT Scustabo: 42731133 ";;51.80;93'749.53;
26.07.2022;26.07.2022;" Tusidedescurunt / Sta.-An. 4122262667 Syllium Sertant VI Forotertinveniavia 70 3678 Loccit AT Scustabo: 37738222 ";;89.00;93'697.73;
26.07.2022;26.07.2022;" Tusidedescurunt / Sta.-An. 2515544785 Syllium Sertant VI Forotertinveniavia 70 3678 Loccit AT Scustabo: 11506372 ";;37.45;93'608.73;
26.07.2022;26.07.2022;" Tusidedescurunt / Sta.-An. 4362227077 Syllium Sertant VI Forotertinveniavia 70 3678 Loccit AT Scustabo: 26215304 ";;219.00;93'571.28;
26.07.2022;26.07.2022;" Tusidedescurunt / Sta.-An. 6660705330 Syllium Sertant VI Forotertinveniavia 70 3678 Loccit AT Scustabo: 30220073 ";;129.00;93'352.28;
26.07.2022;26.07.2022;" Tusidedescurunt / Sta.-An. 3274252554 Syllium Sertant VI Forotertinveniavia 70 3678 Loccit AT Scustabo: 84004860 ";;510.00;93'223.28;
26.07.2022;26.07.2022;" Tusidedescurunt / Sta.-An. 5315642840 Syllium Sertant VI Forotertinveniavia 70 3678 Loccit AT Scustabo: 31272562 ";;79.00;92'713.28;
26.07.2022;26.07.2022;" Tusidedescurunt / Sta.-An. 1327211737 Syllium Sertant VI Forotertinveniavia 70 3678 Loccit AT Scustabo: 31758104 ";;469.00;92'634.28;
26.07.2022;26.07.2022;" Tusidedescurunt / Sta.-An. 1700204706 Syllium Sertant VI Forotertinveniavia 70 3678 Loccit AT Scustabo: 47756775 ";;109.00;92'165.28;
26.07.2022;26.07.2022;" Tusidedescurunt / Sta.-An. 3883520012 Syllium Sertant VI Forotertinveniavia 70 3678 Loccit AT Scustabo: 74141610 ";;89.00;92'056.28;
26.07.2022;26.07.2022;" Tusidedescurunt / Sta.-An. 2476413361 Syllium Sertant VI Forotertinveniavia 70 3678 Loccit AT Scustabo: 12646203 ";;109.00;91'967.28;
26.07.2022;26.07.2022;" Tusidedescurunt / Sta.-An. 4651281358 Syllium Sertant VI Forotertinveniavia 70 3678 Loccit AT Scustabo: 30712038 ";;89.00;91'858.28;
26.07.2022;26.07.2022;" Tusidedescurunt / Sta.-An. 5666758747 Syllium Sertant VI Forotertinveniavia 70 3678 Loccit AT Scustabo: 24845103 ";;48.00;91'769.28;
26.07.2022;26.07.2022;" Tusidedescurunt / Sta.-An. 8334833255 Syllium Sertant VI Forotertinveniavia 70 3678 Loccit AT Scustabo: 11044740 ";;199.00;91'721.28;
26.07.2022;26.07.2022;" Tusidedescurunt / Sta.-An. 7602612318 Syllium Sertant VI Forotertinveniavia 70 3678 Loccit AT Scustabo: 52606425 ";;119.00;91'522.28;
26.07.2022;26.07.2022;" Tusidedescurunt / Sta.-An. 4680828276 Syllium Sertant VI Forotertinveniavia 70 3678 Loccit AT Scustabo: 28324760 ";;48.00;91'403.28;
26.07.2022;26.07.2022;" Tusidedescurunt / Sta.-An. 6721443872 Syllium Sertant VI Forotertinveniavia 70 3678 Loccit AT Scustabo: 52735155 ";;89.00;91'355.28;
26.07.2022;26.07.2022;" Tusidedescurunt / Sta.-An. 3787473521 Syllium Sertant VI Forotertinveniavia 70 3678 Loccit AT Scustabo: 83031687 ";;129.00;91'266.28;
26.07.2022;26.07.2022;" Tusidedescurunt / Sta.-An. 3256136127 Syllium Sertant VI Forotertinveniavia 70 3678 Loccit AT Scustabo: 66457464 ";;89.00;91'137.28;
26.07.2022;26.07.2022;" Tusidedescurunt / Sta.-An. 5743278075 Syllium Sertant VI Forotertinveniavia 70 3678 Loccit AT Scustabo: 54081024 ";;89.00;91'048.28;
26.07.2022;26.07.2022;" Tusidedescurunt / Sta.-An. 4162408254 Syllium Sertant VI Forotertinveniavia 70 3678 Loccit AT Scustabo: 43362434 ";;84.00;90'959.28;
26.07.2022;26.07.2022;" Tusidedescurunt / Sta.-An. 6021600384 Syllium Sertant VI Forotertinveniavia 70 3678 Loccit AT Scustabo: 21276041 ";;119.00;90'875.28;
26.07.2022;23.07.2022;Orunarenti sus Morabibruntrarat MINVES *EMI6321070112 327-565-4814 RIT Parte Silevolone Sentquobitus 2077 2243 1846 6404 23.44.4118 76:75;1'000.00;;90'756.28;
26.07.2022;26.07.2022;" Tusidedescurunt / Sta.-An. 7546764604 BONUM Secriduor VI Sugavictotagindiam 55 8531 Loccit AT Scustabo: 164022 BONUM si81g4g4-50ng-2175-x36 6-32os5607h534 Faciet 73738342 Tesse: 640.82 Scro: -6.11 ";;105.51;91'756.28;
26.07.2022;26.07.2022;" Tusidedescurunt / Sta.-An. 8452211073 BONUM Secriduor VI Sugavictotagindiam 55 8531 Loccit AT Scustabo: 164022 BONUM si81g4g4-50ng-2175-x36 6-32os5607h534 Faciet 31704484 Tesse: 303.70 Scro: -1.61 ";;637.20;91'650.77;
26.07.2022;26.07.2022;" Peramente v-chorope / Sta.-An. 8161732368 SOLUCI + CAREA VI PICTURATIATERE 1 8600 ACUISUAERE ";221.20;;91'013.57;
26.07.2022;26.07.2022;" Peramente v-chorope / Sta.-An. 7118500610 NWSVO82.STA VI VIDEBITTESTICONIS 65 5208 PUTUM Careperada: FUNGA QUALIONTERRE ";3'877.20;;91'234.77;
26.07.2022;26.07.2022;" Tusidedescurunt / Sta.-An. 5585470107 DECTUENEM CULCEAT VI TIANTEMPLUMQUIT 533 AT 3678 EXPECTO Scustabo: EMO / 237.13/AN.6100502524/COR. 75.82/FUN.51.44.4118/Dixitquila Parget An/Pier ";;968.13;95'111.97;
26.07.2022;26.07.2022;" Tusidedescurunt / Sta.-An. 5372418023 DECTUENEM CULCEAT VI TIANTEMPLUMQUIT 533 AT 3678 EXPECTO Scustabo: EMO / 6212.82/AN.7857303504/COR. 8.51/FUN.23.44.4118/Actom Totenignumni /Motudiperunt ";;3'197.10;94'143.84;
26.07.2022;26.07.2022;" Tusidedescurunt / Sta.-An. 1162415112 DECTUENEM CULCEAT VI TIANTEMPLUMQUIT 533 AT 3678 EXPECTO Scustabo: EMO / 6105.62/AN.7501587830/COR. 6.55/FUN.73.44.4118/Actom Totenignumni /Motudiperunt ";;3'127.58;90'946.74;
26.07.2022;26.07.2022;" Tusidedescurunt / Sta.-An. 4102603864 TERIENDIERVA AT Tum ut Sustell 2 1471 Pectom ET AT Scustabo: Cestiury 73.44.73 - 67.44.73 ";;3'264.81;87'819.16;
25.07.2022;25.07.2022;" Tusidedescurunt / Sta.-An. 2633271333 CARAER QUE DIT SUPERIT PARE 81-37 REGATA IMULO 1 ARIGNIGIT 76376 OS 76376 Scustabo: 4234866004888 ";;1'279.67;84'554.35;
25.07.2022;25.07.2022;" Tusidedescurunt / Sta.-An. 4522701835 Syllium Sertant VI Forotertinveniavia 70 3678 Loccit AT Scustabo: 57231884 ";;49.00;83'274.68;
25.07.2022;25.07.2022;" Tusidedescurunt / Sta.-An. 3285323643 Syllium Sertant VI Forotertinveniavia 70 3678 Loccit AT Scustabo: 54342857 ";;99.00;83'225.68;
25.07.2022;25.07.2022;" Tusidedescurunt / Sta.-An. 6342314486 Syllium Sertant VI Forotertinveniavia 70 3678 Loccit AT Scustabo: 68641311 ";;430.00;83'126.68;
25.07.2022;25.07.2022;" Tusidedescurunt / Sta.-An. 7375158824 Syllium Sertant VI Forotertinveniavia 70 3678 Loccit AT Scustabo: 56715064 ";;64.79;82'696.68;
25.07.2022;25.07.2022;" Tusidedescurunt / Sta.-An. 6733865204 Syllium Sertant VI Forotertinveniavia 70 3678 Loccit AT Scustabo: 43828132 ";;129.00;82'631.89;
25.07.2022;25.07.2022;" Tusidedescurunt / Sta.-An. 8423270556 Syllium Sertant VI Forotertinveniavia 70 3678 Loccit AT Scustabo: 64117154 ";;89.00;82'502.89;
25.07.2022;25.07.2022;" Tusidedescurunt / Sta.-An. 1134213265 VoloNerigem VI Tangobasciete 85 3437 Mern AT Scustabo: VOLONERIGEM P-QUAEQUE dabit://actom totenignumni.at NJWT70RT6407147 103 85657G62455076734248 STRELL ALE 368 .13. COR ALE 8.83 ";;206.28;82'413.89;
25.07.2022;25.07.2022;" Peramente v-chorope / Sta.-An. 7182780811 SYLLIUM SERTANT VI FOROTERTINVENIAVIA 42D AT-3678 EXPECTO Careperada: POPILLIS 20584607 ";1'290.90;;82'207.61;
25.07.2022;25.07.2022;" Peramente v-chorope / Sta.-An. 1525320405 ENIARE STINQUAM SEGI VIUNGRUCIMITUDO 73 8016 TATINNO Careperada: REQUOBSIT-AN.: 8132284038 Sculaüludiscem Fentanticuro: DIXITQUILA PARGET SEGI ";45.55;;83'498.51;
25.07.2022;25.07.2022;" Peramente v-chorope / Sta.-An. 3072831218 SOLO PLAM SEGI 6836 AGNUM Careperada: 72647 ";235.75;;83'544.06;
25.07.2022;25.07.2022;" Peramente v-chorope / Sta.-An. 7767325242 MARIRIDEM B.L. PERINUMN NANTUNAM M/ DEPE SERRUM 7 OBSQUE 41 76163 SUBILE MATETE Careperada: 783+255 Risino: LIS 611.41 Bitiaviccem: 5.803177 (LIS/ALE) ";364.74;;83'779.81;
25.07.2022;25.07.2022;" Tusidedescurunt / Sta.-An. 4420138457 DECTUENEM CULCEAT VI TIANTEMPLUMQUIT 533 AT 3678 EXPECTO Scustabo: EMO / 2044.62/AN.4724446814/COR. 75.40/FUN.61.44.4118/Actom Totenignumni /Motudiperunt ";;2'843.88;84'144.55;
25.07.2022;25.07.2022;" Tusidedescurunt / Sta.-An. 3161683058 Ponendix B. sus Postri C. O Diondabica 53 7568 Untimultunno AT Scustabo: Contuunt Discera Parangionduludo ";;15.00;81'300.67;
25.07.2022;25.07.2022;" Tusidedescurunt / Sta.-An. 8362534124 SUBSITE SegI-Mago sex Funtubi Impectamponver 54F 8860 Bontibus AT Scustabo: Experturbo 76.44.4118 ";;120.95;81'285.67;
25.07.2022;25.07.2022;" Tusidedescurunt / Sta.-An. 2566518410 Obsive Strica Puliqualitanarall 41 AT-7804 Gentemperum Scustabo: Statiarado. 40360762 ";;6'853.80;81'164.72;
25.07.2022;25.07.2022;" Tusidedescurunt / Sta.-An. 2421848434 VoloNerigem VI Tangobasciete 85 3437 Mern AT Scustabo: VOLONERIGEM ANT/PRO CALTIO 1632 Num diuniunix TC6826562226777 14333451P 76263271812782 STRELL ALE 3163.13. COR ALE 5.24 ";;1'521.54;74'310.92;
25.07.2022;25.07.2022;" Tusidedescurunt / Sta.-An. 2631875765 VoloNerigem VI Tangobasciete 85 3437 Mern AT Scustabo: VOLONERIGEM ANT/PRO CALTIO 1632 Num diuniunix TC6826562226777 68743840W 64651533645480 STRELL ALE 1557.13. COR ALE 5.24 ";;1'275.54;72'789.38;
25.07.2022;25.07.2022;" Tusidedescurunt / Sta.-An. 6836284653 VoloNerigem VI Tangobasciete 85 3437 Mern AT Scustabo: VOLONERIGEM P-QUAEQUE dabit://actom totenignumni.at NJWT70RT6407147 103 54413O03310118012547 STRELL ALE 612 .13. COR ALE 8.18 ";;205.30;71'513.84;
22.07.2022;22.07.2022;" Tusidedescurunt / Sta.-An. 7763517864 Syllium Sertant VI Forotertinveniavia 70 3678 Loccit AT Scustabo: 24185727 ";;48.00;71'308.54;
22.07.2022;22.07.2022;" Tusidedescurunt / Sta.-An. 3086116378 Syllium Sertant VI Forotertinveniavia 70 3678 Loccit AT Scustabo: 70426583 ";;48.00;71'260.54;
22.07.2022;22.07.2022;" Tusidedescurunt / Sta.-An. 1822780854 Syllium Sertant VI Forotertinveniavia 70 3678 Loccit AT Scustabo: 71780860 ";;175.00;71'212.54;
22.07.2022;22.07.2022;" Tusidedescurunt / Sta.-An. 6585748430 Syllium Sertant VI Forotertinveniavia 70 3678 Loccit AT Scustabo: 32668873 ";;349.00;71'037.54;
22.07.2022;22.07.2022;" Tusidedescurunt / Sta.-An. 4485127046 Syllium Sertant VI Forotertinveniavia 70 3678 Loccit AT Scustabo: 65787131 ";;89.00;70'688.54;
22.07.2022;22.07.2022;" Tusidedescurunt / Sta.-An. 5600134331 Syllium Sertant VI Forotertinveniavia 70 3678 Loccit AT Scustabo: 20753426 ";;79.00;70'599.54;
22.07.2022;22.07.2022;" Tusidedescurunt / Sta.-An. 1312630151 Syllium Sertant VI Forotertinveniavia 70 3678 Loccit AT Scustabo: 25124471 ";;349.00;70'520.54;
22.07.2022;22.07.2022;" Tusidedescurunt / Sta.-An. 8526445533 Syllium Sertant VI Forotertinveniavia 70 3678 Loccit AT Scustabo: 76758066 ";;269.00;70'171.54;
22.07.2022;22.07.2022;" Tusidedescurunt / Sta.-An. 6172766614 Syllium Sertant VI Forotertinveniavia 70 3678 Loccit AT Scustabo: 35603602 ";;109.00;69'902.54;
22.07.2022;22.07.2022;" Tusidedescurunt / Sta.-An. 4211276664 Syllium Sertant VI Forotertinveniavia 70 3678 Loccit AT Scustabo: 82788268 ";;209.00;69'793.54;
22.07.2022;22.07.2022;" Tusidedescurunt / Sta.-An. 4177777885 Syllium Sertant VI Forotertinveniavia 70 3678 Loccit AT Scustabo: 32626366 ";;89.00;69'584.54;
22.07.2022;22.07.2022;" Tusidedescurunt / Sta.-An. 1782670565 VoloNerigem VI Tangobasciete 85 3437 Mern AT Scustabo: VOLONERIGEM P-QUAEQUE dabit://actom totenignumni.at NJWT70RT6407147 103 12506O60382333270324 STRELL ALE 378 .13. COR ALE 7.13 ";;354.33;69'495.54;
22.07.2022;22.07.2022;" Tusidedescurunt / Sta.-An. 8207584580 BONUM Secriduor VI Sugavictotagindiam 55 8531 Loccit AT Scustabo: 164022 BONUM si81g4g4-50ng-2175-x36 6-32os5607h534 Faciet 77217158 Tesse: 77.82 Scro: -5.47 ";;68.99;69'141.21;
22.07.2022;20.07.2022;Orunarenti sus Morabibruntrarat MINVES *EMI6321070112 327-565-4814 RIT Parte Silevolone Sentquobitus 2077 2243 1846 6404 85.44.4118 86:88;1'000.00;;69'072.22;
22.07.2022;22.07.2022;" Tusidedescurunt / Sta.-An. 6086863600 AUPERIT OFFERES COGIORTUDABIT LEBRECEM AUDIDEVOLUVISTRICUM 41 AT 1832 PLANT Scustabo: STATIARADO. 78076750 ";;4'825.80;70'072.22;
22.07.2022;22.07.2022;" Tusidedescurunt / Sta.-An. 5568110560 AUCUPA SERRUM LAVA J/L HOLO OBSIVE OLVERI LAVA SICULA XXX ADIONE 50 AT 7566 RETRAT ";;3'749.30;65'246.42;
22.07.2022;22.07.2022;" Tusidedescurunt / Sta.-An. 7868804424 DECTUENEM CULCEAT VI TIANTEMPLUMQUIT 533 AT 3678 EXPECTO Scustabo: EMO / 8667.13/AN.6513441781/COR. 61.88/FUN.85.44.4118/Actom Totenignumni /Motudiperunt ";;1'598.48;61'497.12;
22.07.2022;22.07.2022;" Tusidedescurunt / Sta.-An. 6853125252 Comnimus-pus-d'Percures. Pare Vi Mulunt-Xxx 33 4218 Pratuonteum AT Scustabo: prope by angitanga aercusta 18877 ";;89.00;59'898.64;
22.07.2022;22.07.2022;" Peramente v-chorope / Sta.-An. 6386474826 ENIARE STINQUAM SEGI VIUNGRUCIMITUDO 73 8016 TATINNO Careperada: REQUOBSIT-AN.: 7553204820 Sculaüludiscem Fentanticuro: DIXITQUILA PARGET SEGI ";44.75;;59'809.64;
22.07.2022;22.07.2022;" Peramente v-chorope / Sta.-An. 5716608478 V. AMILIA HIUNT F/B O SERIRE 23 O XXX 8453 GRECUTE Careperada: RICENDIDEVOS Risino: LIS 8'864.13 Bitiaviccem: 6.307856 (LIS/ALE) ";2'512.09;;59'854.39;
22.07.2022;22.07.2022;" Tusidedescurunt / Sta.-An. 1466434303 Dedduobar VETE SegI Mitantio 75 5743 Habige AT Scustabo: Retteque Sempute/SM1850422260/IP70257138/EI3/VJ667.13/IN-33.55 ";;901.59;62'366.48;
21.07.2022;21.07.2022;" Tusidedescurunt / Sta.-An. 2220532635 BONUM Secriduor VI Sugavictotagindiam 55 8531 Loccit AT Scustabo: 164022 BONUM si81g4g4-50ng-2175-x36 6-32os5607h534 Faciet 27403363 Tesse: 838.82 Scro: -7.41 ";;377.92;61'464.89;
21.07.2022;21.07.2022;" Tusidedescurunt / Sta.-An. 1781877274 DECTUENEM CULCEAT VI TIANTEMPLUMQUIT 533 AT 3678 EXPECTO Scustabo: EMO / 354.13/AN.2725547632/COR. 6.40/FUN.76.44.4118/Actom Totenignumni /Motudiperunt ";;864.38;61'086.97;
21.07.2022;21.07.2022;" Peramente v-chorope / Sta.-An. 7574320184 PARTUDABO STRAE PARAESERACIT 7 7370 NOSTQUERRE Careperada: 41126841 ";218.86;;60'222.59;
21.07.2022;21.07.2022;" Üholvent nem 3711.1051.8222 Dixitquila Parget SegI / Sta.-An. 1834804383 ";9'000.00;;60'441.45;
20.07.2022;20.07.2022;Gentesuuntimint Caurre Ino Punnerbit 72 7851 Pier;;2'340.00;69'441.45;
20.07.2022;20.07.2022;" Tusidedescurunt / Sta.-An. 8708638804 Syllium Sertant VI Forotertinveniavia 70 3678 Loccit AT Scustabo: 47805171 ";;185.00;67'101.45;
20.07.2022;20.07.2022;" Tusidedescurunt / Sta.-An. 8655356057 Syllium Sertant VI Forotertinveniavia 70 3678 Loccit AT Scustabo: 15452146 ";;89.00;66'916.45;
20.07.2022;20.07.2022;" Tusidedescurunt / Sta.-An. 6522133578 Syllium Sertant VI Forotertinveniavia 70 3678 Loccit AT Scustabo: 42554300 ";;89.00;66'827.45;
20.07.2022;20.07.2022;" Tusidedescurunt / Sta.-An. 5870674730 Syllium Sertant VI Forotertinveniavia 70 3678 Loccit AT Scustabo: 67667542 ";;719.01;66'738.45;
20.07.2022;20.07.2022;" Tusidedescurunt / Sta.-An. 3268506462 Syllium Sertant VI Forotertinveniavia 70 3678 Loccit AT Scustabo: 33812272 ";;89.00;66'019.44;
20.07.2022;20.07.2022;" Tusidedescurunt / Sta.-An. 6868463211 Syllium Sertant VI Forotertinveniavia 70 3678 Loccit AT Scustabo: 67157147 ";;89.00;65'930.44;
20.07.2022;20.07.2022;" Tusidedescurunt / Sta.-An. 5300531057 Syllium Sertant VI Forotertinveniavia 70 3678 Loccit AT Scustabo: 15348020 ";;89.00;65'841.44;
20.07.2022;20.07.2022;" Tusidedescurunt / Sta.-An. 4261383818 Syllium Sertant VI Forotertinveniavia 70 3678 Loccit AT Scustabo: 78804208 ";;510.00;65'752.44;
20.07.2022;20.07.2022;" Tusidedescurunt / Sta.-An. 4241174673 Syllium Sertant VI Forotertinveniavia 70 3678 Loccit AT Scustabo: 55120203 ";;429.00;65'242.44;
20.07.2022;20.07.2022;" Tusidedescurunt / Sta.-An. 2653755165 Syllium Sertant VI Forotertinveniavia 70 3678 Loccit AT Scustabo: 50560570 ";;79.00;64'813.44;
20.07.2022;20.07.2022;" Tusidedescurunt / Sta.-An. 1750238522 Syllium Sertant VI Forotertinveniavia 70 3678 Loccit AT Scustabo: 75702735 ";;189.00;64'734.44;
20.07.2022;20.07.2022;" Tusidedescurunt / Sta.-An. 2822340128 Syllium Sertant VI Forotertinveniavia 70 3678 Loccit AT Scustabo: 18370421 ";;359.00;64'545.44;
20.07.2022;20.07.2022;" Tusidedescurunt / Sta.-An. 6846812041 Syllium Sertant VI Forotertinveniavia 70 3678 Loccit AT Scustabo: 74677334 ";;149.00;64'186.44;
20.07.2022;20.07.2022;" Tusidedescurunt / Sta.-An. 8088672775 BONUM Secriduor VI Sugavictotagindiam 55 8531 Loccit AT Scustabo: 164022 BONUM si81g4g4-50ng-2175-x36 6-32os5607h534 Faciet 34414864 Tesse: 3853.82 Scro: -73.11 ";;1'718.27;64'037.44;
19.07.2022;19.07.2022;" Tusidedescurunt / Sta.-An. 5062288308 BONUM Secriduor VI Sugavictotagindiam 55 8531 Loccit AT Scustabo: 164022 BONUM si81g4g4-50ng-2175-x36 6-32os5607h534 Faciet 80646025 Tesse: 11.82 Scro: -5.88 ";;39.38;62'319.17;
19.07.2022;19.07.2022;" Tusidedescurunt / Sta.-An. 8762416322 Syllium Sertant VI Forotertinveniavia 70 3678 Loccit AT Scustabo: 21200482 ";;89.00;62'279.79;
19.07.2022;19.07.2022;" Tusidedescurunt / Sta.-An. 2526327605 Syllium Sertant VI Forotertinveniavia 70 3678 Loccit AT Scustabo: 67831387 ";;37.90;62'190.79;
19.07.2022;19.07.2022;" Tusidedescurunt / Sta.-An. 3864356818 Syllium Sertant VI Forotertinveniavia 70 3678 Loccit AT Scustabo: 63756400 ";;349.00;62'152.89;
19.07.2022;19.07.2022;" Tusidedescurunt / Sta.-An. 6642251438 Syllium Sertant VI Forotertinveniavia 70 3678 Loccit AT Scustabo: 81376144 ";;89.00;61'803.89;
19.07.2022;19.07.2022;" Tusidedescurunt / Sta.-An. 4830207358 Syllium Sertant VI Forotertinveniavia 70 3678 Loccit AT Scustabo: 82045827 ";;129.00;61'714.89;
19.07.2022;19.07.2022;" Tusidedescurunt / Sta.-An. 4407210622 BONUM Secriduor VI Sugavictotagindiam 55 8531 Loccit AT Scustabo: 164022 BONUM si81g4g4-50ng-2175-x36 6-32os5607h534 Faciet 41385057 Tesse: 274.13 Scro: -8.36 ";;170.75;61'585.89;
19.07.2022;19.07.2022;" Tusidedescurunt / Sta.-An. 2434238428 TERIENDIERVA AT Tum ut Sustell 2 1471 Pectom ET AT Scustabo: Cestiury 31.44.73 - 61.44.73 ";;2'170.27;61'415.14;
19.07.2022;16.07.2022;Orunarenti sus Morabibruntrarat MINVES *EMI6321070112 327-565-4814 RIT Parte Silevolone Sentquobitus 2077 2243 1846 6404 23.44.4118 44:36;1'000.00;;59'244.87;
19.07.2022;19.07.2022;" Tusidedescurunt / Sta.-An. 5517683870 DECTUENEM CULCEAT VI TIANTEMPLUMQUIT 533 AT 3678 EXPECTO Scustabo: EMO / 2134.13/AN.2218308818/COR. 23.31/FUN.23.44.4118/Dixitquila Parget An/Pier ";;1'254.85;60'244.87;
19.07.2022;19.07.2022;" Tusidedescurunt / Sta.-An. 5318363405 DECTUENEM CULCEAT VI TIANTEMPLUMQUIT 533 AT 3678 EXPECTO Scustabo: EMO / 8681.13/AN.3076532228/COR. 151.55/FUN.23.44.4118/Actom Totenignumni /Motudiperunt ";;8'187.26;58'990.02;
19.07.2022;19.07.2022;" Peramente v-chorope / Sta.-An. 3503433114 ADA CULCEAT VI MIRACUCCIDUNTION 55 4450 NEINI DE ";2'822.75;;50'802.76;
19.07.2022;19.07.2022;" Peramente v-chorope / Sta.-An. 3802375518 IN PRATUNDIAM VI 8512 REM PILIS Careperada: LUNGUSTELL 165624 ";119.00;;53'625.51;
19.07.2022;19.07.2022;" Tusidedescurunt / Sta.-An. 5117766517 DECTUENEM CULCEAT VI TIANTEMPLUMQUIT 533 AT 3678 EXPECTO Scustabo: EMO / 3834.13/AN.6431500783/COR. 58.57/FUN.31.44.4118/Actom Totenignumni /Motudiperunt ";;1'821.03;53'744.51;
19.07.2022;19.07.2022;" Tusidedescurunt / Sta.-An. 5283737725 DECTUENEM CULCEAT VI TIANTEMPLUMQUIT 533 AT 3678 EXPECTO Scustabo: EMO / 133.13/AN.3564744002/COR. 23.24/FUN.31.44.4118/Dixitquila Parget An/Pier ";;739.54;51'923.48;
18.07.2022;18.07.2022;" Tusidedescurunt / Sta.-An. 1637808387 Tiorte Rignius Propro Volvetini 28 2347 Lonteristrat ";;479.00;51'183.94;
18.07.2022;18.07.2022;" Tusidedescurunt / Sta.-An. 7326103218 Tiorte Rignius Propro Volvetini 28 2347 Lonteristrat ";;3'670.10;50'704.94;
18.07.2022;18.07.2022;" Tusidedescurunt / Sta.-An. 7143604848 Syllium Sertant VI Forotertinveniavia 70 3678 Loccit AT Scustabo: 76577678 ";;209.00;47'034.84;
18.07.2022;18.07.2022;" Tusidedescurunt / Sta.-An. 7033164452 Syllium Sertant VI Forotertinveniavia 70 3678 Loccit AT Scustabo: 11383782 ";;89.00;46'825.84;
18.07.2022;18.07.2022;" Tusidedescurunt / Sta.-An. 6833627076 Syllium Sertant VI Forotertinveniavia 70 3678 Loccit AT Scustabo: 30632486 ";;89.00;46'736.84;
18.07.2022;18.07.2022;" Tusidedescurunt / Sta.-An. 5811647603 Syllium Sertant VI Forotertinveniavia 70 3678 Loccit AT Scustabo: 44821846 ";;250.00;46'647.84;
18.07.2022;18.07.2022;" Tusidedescurunt / Sta.-An. 2430702026 Syllium Sertant VI Forotertinveniavia 70 3678 Loccit AT Scustabo: 42681503 ";;129.00;46'397.84;
18.07.2022;18.07.2022;" Tusidedescurunt / Sta.-An. 5062855661 Syllium Sertant VI Forotertinveniavia 70 3678 Loccit AT Scustabo: 64054303 ";;49.00;46'268.84;
18.07.2022;18.07.2022;" Tusidedescurunt / Sta.-An. 7524810216 Syllium Sertant VI Forotertinveniavia 70 3678 Loccit AT Scustabo: 10533337 ";;59.90;46'219.84;
18.07.2022;18.07.2022;" Tusidedescurunt / Sta.-An. 6256625380 Syllium Sertant VI Forotertinveniavia 70 3678 Loccit AT Scustabo: 26222006 ";;89.00;46'159.94;
18.07.2022;18.07.2022;" Tusidedescurunt / Sta.-An. 5302682662 Syllium Sertant VI Forotertinveniavia 70 3678 Loccit AT Scustabo: 37820424 ";;79.00;46'070.94;
18.07.2022;18.07.2022;" Tusidedescurunt / Sta.-An. 2557012068 Syllium Sertant VI Forotertinveniavia 70 3678 Loccit AT Scustabo: 44286581 ";;516.00;45'991.94;
18.07.2022;18.07.2022;" Peramente v-chorope / Sta.-An. 5718748632 BY PIER 7851 PIER Careperada: POPILLIS 4118/222 ";1'500.00;;45'475.94;
18.07.2022;18.07.2022;" Peramente v-chorope / Sta.-An. 3850316330 V+H CURRED NOCAT VI ITTIUSQUATIONCILA 47 1206 CAPINIS Careperada: 15320444 - 65/67/4118 13:13 Sculaüludiscem Fentanticuro: DIXITQUILA PARGET SEGI ";230.65;;46'975.94;
18.07.2022;18.07.2022;" Peramente v-chorope / Sta.-An. 4856256246 PARTUDABO STRAE PARAESERACIT 7 7370 NOSTQUERRE Careperada: 12707212 ";177.76;;47'206.59;
18.07.2022;18.07.2022;" Tusidedescurunt / Sta.-An. 5228047078 DECTUENEM CULCEAT VI TIANTEMPLUMQUIT 533 AT 3678 EXPECTO Scustabo: EMO / 334.13/AN.5415723875/COR. 41.28/FUN.23.44.4118/Actom Totenignumni /Motudiperunt ";;902.17;47'384.35;
18.07.2022;18.07.2022;" Peramente v-chorope / Sta.-An. 2388505068 SECTUDUNIAM SEGI RORGENTUUNIS 41 3880 DORDUCTUDO Careperada: EE17/560823 Risino: LIS 8'351.57 Bitiaviccem: 6.674530 (LIS/ALE) ";2'216.84;;46'482.18;
18.07.2022;18.07.2022;" Tusidedescurunt / Sta.-An. 1505757026 Dedduobar VETE SegI Mitantio 75 5743 Habige AT Scustabo: Retteque Sempute/SM1850422260/SM86016174/EI3/TT8014.13/IN-65.85 ";;2'473.80;48'699.02;
18.07.2022;18.07.2022;" Tusidedescurunt / Sta.-An. 8081842002 VoloNerigem VI Tangobasciete 85 3437 Mern AT Scustabo: VOLONERIGEM P-QUAEQUE dabit://actom totenignumni.at NJWT70RT6407147 103 88700W81415111325140 STRELL ALE 872 .13. COR ALE 41.14 ";;857.70;46'225.22;
15.07.2022;15.07.2022;" Tusidedescurunt / Sta.-An. 5816612325 Syllium Sertant VI Forotertinveniavia 70 3678 Loccit AT Scustabo: 84402117 ";;109.00;45'367.52;
15.07.2022;15.07.2022;" Tusidedescurunt / Sta.-An. 6777176617 Syllium Sertant VI Forotertinveniavia 70 3678 Loccit AT Scustabo: 82733015 ";;1'150.00;45'258.52;
15.07.2022;15.07.2022;" Tusidedescurunt / Sta.-An. 4044521320 Syllium Sertant VI Forotertinveniavia 70 3678 Loccit AT Scustabo: 40450376 ";;39.00;44'108.52;
15.07.2022;15.07.2022;" Tusidedescurunt / Sta.-An. 1438734664 Syllium Sertant VI Forotertinveniavia 70 3678 Loccit AT Scustabo: 67205630 ";;48.00;44'069.52;
15.07.2022;15.07.2022;" Tusidedescurunt / Sta.-An. 1308727606 Syllium Sertant VI Forotertinveniavia 70 3678 Loccit AT Scustabo: 16410348 ";;89.00;44'021.52;
15.07.2022;15.07.2022;" Tusidedescurunt / Sta.-An. 3376104502 Syllium Sertant VI Forotertinveniavia 70 3678 Loccit AT Scustabo: 64545073 ";;89.00;43'932.52;
15.07.2022;15.07.2022;" Tusidedescurunt / Sta.-An. 2820337301 Syllium Sertant VI Forotertinveniavia 70 3678 Loccit AT Scustabo: 53301411 ";;89.00;43'843.52;
15.07.2022;15.07.2022;" Tusidedescurunt / Sta.-An. 3333183545 Syllium Sertant VI Forotertinveniavia 70 3678 Loccit AT Scustabo: 33715300 ";;29.90;43'754.52;
15.07.2022;15.07.2022;" Tusidedescurunt / Sta.-An. 3207183482 Syllium Sertant VI Forotertinveniavia 70 3678 Loccit AT Scustabo: 66122683 ";;129.00;43'724.62;
15.07.2022;15.07.2022;" Tusidedescurunt / Sta.-An. 5841032522 VoloNerigem VI Tangobasciete 85 3437 Mern AT Scustabo: VOLONERIGEM ANT/PRO CALTIO 1632 Num diuniunix TC6826562226777 11078847Y 23858540001042 STRELL ALE 340.13. O SI ALE 5.23 ";;449.77;43'595.62;
15.07.2022;15.07.2022;" Tusidedescurunt / Sta.-An. 4142648034 BONUM Secriduor VI Sugavictotagindiam 55 8531 Loccit AT Scustabo: 164022 BONUM si81g4g4-50ng-2175-x36 6-32os5607h534 Faciet 12873467 Tesse: 118.13 Scro: -8.24 ";;186.54;43'145.85;
15.07.2022;15.07.2022;" Tusidedescurunt / Sta.-An. 5838850687 CARAER QUE DIT SUPERIT PARE 81-37 REGATA IMULO 1 ARIGNIGIT 76376 OS 76376 Scustabo: 3367602824851 ";;6'016.27;42'959.31;
15.07.2022;15.07.2022;" Peramente v-chorope / Sta.-An. 4584800881 VIRUNT PARGET ADRABITI SEGI QUAESEMPECUM 23 3538 TERAECIT Careperada: POPILLIS 5447226380 ";1'754.40;;36'943.04;
15.07.2022;15.07.2022;" Peramente v-chorope / Sta.-An. 6342633435 EXPEDERA CULCEAT VI UTANGRELEGIT 81 3118 EXPECTO ";448.20;;38'697.44;
15.07.2022;15.07.2022;" Peramente v-chorope / Sta.-An. 8141201048 LUDUM EXPERURELIS + MOLETE VI SURBITRIMPLATE 33 6273 RESCITTERE Careperada: POPILLIS AN. 110773 Sculaüludiscem Fentanticuro: DIXITQUILA PARGET SEGI ";529.35;;39'145.64;
15.07.2022;15.07.2022;" Peramente v-chorope / Sta.-An. 4775747620 RIDIVITA VI 3318 NAVADITIRE ";490.85;;39'674.99;
15.07.2022;15.07.2022;" Peramente v-chorope / Sta.-An. 4761731107 RENDA QUISPOTUDIT VI CONGOBITUNCRELIGE 7 8037 DIXITIORSERES ";322.80;;40'165.84;
15.07.2022;15.07.2022;" Tusidedescurunt / Sta.-An. 8264056258 Aucupa Malia Seque Adulursus 73 8265 Agnis Scustabo: Fortubit-An. 43626757 ";;1'308.00;40'488.64;
14.07.2022;14.07.2022;" Tusidedescurunt / Sta.-An. 2283528677 VoloNerigem VI Tangobasciete 85 3437 Mern AT Scustabo: VOLONERIGEM P-QUAEQUE dabit://actom totenignumni.at NJWT70RT6407147 103 76453H57442862207356 STRELL ALE 564 .13. COR ALE 7.28 ";;329.66;39'180.64;
14.07.2022;14.07.2022;" Tusidedescurunt / Sta.-An. 7765765437 BONUM Secriduor VI Sugavictotagindiam 55 8531 Loccit AT Scustabo: 164022 BONUM si81g4g4-50ng-2175-x36 6-32os5607h534 Faciet 65603865 Tesse: 340.13 Scro: -6.67 ";;444.15;38'850.98;
14.07.2022;12.07.2022;Orunarenti sus Morabibruntrarat MINVES *EMI6321070112 327-565-4814 RIT Parte Silevolone Sentquobitus 2077 2243 1846 6404 31.44.4118 44:58;1'000.00;;38'406.83;
14.07.2022;14.07.2022;" Tusidedescurunt / Sta.-An. 6507425013 DECTUENEM CULCEAT VI TIANTEMPLUMQUIT 533 AT 3678 EXPECTO Scustabo: EMO / 421.13/AN.3336407386/COR. 54.31/FUN.31.44.4118/Dixitquila Parget An/Pier ";;545.88;39'406.83;
14.07.2022;14.07.2022;" Peramente v-chorope / Sta.-An. 8145864087 V. AMILIA HIUNT F/B O SERIRE 23 O XXX 8453 GRECUTE Careperada: RICENDIDEVOS Risino: LIS 8'864.13 Bitiaviccem: 6.302335 (LIS/ALE) ";2'504.24;;38'860.95;
13.07.2022;13.07.2022;" Tusidedescurunt / Sta.-An. 1723330406 Syllium Sertant VI Forotertinveniavia 70 3678 Loccit AT Scustabo: 53477445 ";;349.00;41'365.19;
13.07.2022;13.07.2022;" Tusidedescurunt / Sta.-An. 7468216866 Syllium Sertant VI Forotertinveniavia 70 3678 Loccit AT Scustabo: 50376367 ";;29.90;41'016.19;
13.07.2022;13.07.2022;" Tusidedescurunt / Sta.-An. 5565504276 Syllium Sertant VI Forotertinveniavia 70 3678 Loccit AT Scustabo: 25736150 ";;349.00;40'986.29;
13.07.2022;13.07.2022;" Tusidedescurunt / Sta.-An. 4437053627 Syllium Sertant VI Forotertinveniavia 70 3678 Loccit AT Scustabo: 14040071 ";;369.00;40'637.29;
13.07.2022;13.07.2022;" Tusidedescurunt / Sta.-An. 8827823803 Syllium Sertant VI Forotertinveniavia 70 3678 Loccit AT Scustabo: 23735514 ";;129.00;40'268.29;
13.07.2022;13.07.2022;" Tusidedescurunt / Sta.-An. 2756524507 Syllium Sertant VI Forotertinveniavia 70 3678 Loccit AT Scustabo: 86503551 ";;39.00;40'139.29;
13.07.2022;13.07.2022;" Tusidedescurunt / Sta.-An. 5631230655 Syllium Sertant VI Forotertinveniavia 70 3678 Loccit AT Scustabo: 16143732 ";;89.00;40'100.29;
13.07.2022;13.07.2022;" Tusidedescurunt / Sta.-An. 3310458332 Syllium Sertant VI Forotertinveniavia 70 3678 Loccit AT Scustabo: 73734641 ";;349.00;40'011.29;
13.07.2022;13.07.2022;" Tusidedescurunt / Sta.-An. 7388854800 Syllium Sertant VI Forotertinveniavia 70 3678 Loccit AT Scustabo: 82586265 ";;89.00;39'662.29;
13.07.2022;13.07.2022;" Tusidedescurunt / Sta.-An. 1832242424 Syllium Sertant VI Forotertinveniavia 70 3678 Loccit AT Scustabo: 43067048 ";;179.00;39'573.29;
13.07.2022;13.07.2022;" Tusidedescurunt / Sta.-An. 5417133866 Syllium Sertant VI Forotertinveniavia 70 3678 Loccit AT Scustabo: 35252100 ";;189.00;39'394.29;
13.07.2022;13.07.2022;" Tusidedescurunt / Sta.-An. 3648504333 BONUM Secriduor VI Sugavictotagindiam 55 8531 Loccit AT Scustabo: 164022 BONUM si81g4g4-50ng-2175-x36 6-32os5607h534 Faciet 73485484 Tesse: 742.70 Scro: -6.48 ";;101.27;39'205.29;
13.07.2022;13.07.2022;" Tusidedescurunt / Sta.-An. 2856614335 DECTUENEM CULCEAT VI TIANTEMPLUMQUIT 533 AT 3678 EXPECTO Scustabo: EMO / 428.13/AN.3236122646/COR. 7.23/FUN.41.44.4118/Dixitquila Parget An/Pier ";;208.84;39'104.02;
13.07.2022;13.07.2022;" Tusidedescurunt / Sta.-An. 8788517034 DECTUENEM CULCEAT VI TIANTEMPLUMQUIT 533 AT 3678 EXPECTO Scustabo: EMO / 5.13/AN.1363546615/COR. 5.13/FUN.41.44.4118/Actom Totenignumni /Motudiperunt ";;213.47;38'895.18;
12.07.2022;12.07.2022;" Tusidedescurunt / Sta.-An. 8526787358 BONUM Secriduor VI Sugavictotagindiam 55 8531 Loccit AT Scustabo: 164022 BONUM si81g4g4-50ng-2175-x36 6-32os5607h534 Faciet 58550716 Tesse: 8041.51 Scro: -51.86 ";;1'858.32;38'681.71;
12.07.2022;12.07.2022;" Tusidedescurunt / Sta.-An. 4845330645 Syllium Sertant VI Forotertinveniavia 70 3678 Loccit AT Scustabo: 32730161 ";;129.00;36'823.39;
12.07.2022;12.07.2022;" Tusidedescurunt / Sta.-An. 5604786317 Syllium Sertant VI Forotertinveniavia 70 3678 Loccit AT Scustabo: 56254772 ";;89.00;36'694.39;
12.07.2022;12.07.2022;" Tusidedescurunt / Sta.-An. 8568342733 BONUM Secriduor VI Sugavictotagindiam 55 8531 Loccit AT Scustabo: 164022 BONUM si81g4g4-50ng-2175-x36 6-32os5607h534 Faciet 74788287 Tesse: 632.13 Scro: -8.47 ";;207.27;36'605.39;
12.07.2022;12.07.2022;" Peramente v-chorope / Sta.-An. 1813248245 CATUNDIXILLUVA SEGI 58551 IMUTIONEM Careperada: O173876 STA-24075 Risino: LIS 6'435.13 Bitiaviccem: 6.104558 (LIS/ALE) ";1'905.44;;36'398.12;
12.07.2022;08.07.2022;Orunarenti sus Morabibruntrarat MINVES *EMI6321070112 327-565-4814 RIT Parte Silevolone Sentquobitus 2077 2243 1846 6404 80.44.4118 31:41;1'000.00;;38'303.56;
12.07.2022;12.07.2022;" Tusidedescurunt / Sta.-An. 3754788641 DECTUENEM CULCEAT VI TIANTEMPLUMQUIT 533 AT 3678 EXPECTO Scustabo: EMO / 1451.62/AN.3064386428/COR. 67.61/FUN.81.44.4118/Actom Totenignumni /Motudiperunt ";;3'114.90;39'303.56;
12.07.2022;12.07.2022;" Tusidedescurunt / Sta.-An. 1351561087 DECTUENEM CULCEAT VI TIANTEMPLUMQUIT 533 AT 3678 EXPECTO Scustabo: EMO / 782.13/AN.1440868251/COR. 23.47/FUN.80.44.4118/Dixitquila Parget An/Pier ";;538.12;36'188.66;
12.07.2022;12.07.2022;" Peramente v-chorope / Sta.-An. 5145837430 COGIT COLEG SEGI MUNCIRCIPARATE-ABER-INI.8 74368 MAGNIBULUVIS Careperada: CONTATURBIGATU + BEATICA VOCANTIAM Risino: LIS 0'233.13 Bitiaviccem: 6.766706 (LIS/ALE) ";6'771.69;;35'650.54;
12.07.2022;12.07.2022;" Peramente v-chorope / Sta.-An. 1347474667 VENTERE PULO VI RECUNDUCENDE 76 1632 MOTUDIPERUNT Careperada: FUNGA ";4'150.00;;42'422.23;
12.07.2022;12.07.2022;" Peramente v-chorope / Sta.-An. 8833133661 FACIDEM VI VENTUDINULI 23 3255 RIUSTA Careperada: BG03820024/ET-4427278 Sculaüludiscem Fentanticuro: ACTOM TOTENIGNUMNI ";229.45;;46'572.23;
12.07.2022;12.07.2022;" Peramente v-chorope / Sta.-An. 4787264582 ALIUM MOLETE SEGI MULLUCUTINI 82 46755 PERCUIUNT Careperada: 3315187 8523224 7632422 Risino: LIS 6'584.68 Bitiaviccem: 6.766706 (LIS/ALE) ";1'799.20;;46'801.68;
12.07.2022;12.07.2022;" Tusidedescurunt / Sta.-An. 4418076406 TERIENDIERVA AT Tum ut Sustell 2 1471 Pectom ET AT Scustabo: Cestiury 80.44.73 - 23.44.73 ";;3'069.37;48'600.88;
12.07.2022;12.07.2022;" Tusidedescurunt / Sta.-An. 2002878058 Iuncus Luniffinix Iginiusquit 3 5328 Muspia Scustabo: 51834 ";;1'157.60;45'531.51;
11.07.2022;11.07.2022;" Tusidedescurunt / Sta.-An. 2281617151 Syllium Sertant VI Forotertinveniavia 70 3678 Loccit AT Scustabo: 48355306 ";;129.00;44'373.91;
11.07.2022;11.07.2022;" Tusidedescurunt / Sta.-An. 4378404580 Syllium Sertant VI Forotertinveniavia 70 3678 Loccit AT Scustabo: 64006321 ";;309.00;44'244.91;
11.07.2022;11.07.2022;" Tusidedescurunt / Sta.-An. 8712305343 Syllium Sertant VI Forotertinveniavia 70 3678 Loccit AT Scustabo: 31763161 ";;54.89;43'935.91;
11.07.2022;11.07.2022;" Tusidedescurunt / Sta.-An. 4800512833 Syllium Sertant VI Forotertinveniavia 70 3678 Loccit AT Scustabo: 13018304 ";;559.00;43'881.02;
11.07.2022;11.07.2022;" Tusidedescurunt / Sta.-An. 5210004622 Syllium Sertant VI Forotertinveniavia 70 3678 Loccit AT Scustabo: 51680740 ";;275.00;43'322.02;
11.07.2022;11.07.2022;" Tusidedescurunt / Sta.-An. 2566432526 Syllium Sertant VI Forotertinveniavia 70 3678 Loccit AT Scustabo: 41742454 ";;854.00;43'047.02;
11.07.2022;11.07.2022;" Tusidedescurunt / Sta.-An. 5404885181 Syllium Sertant VI Forotertinveniavia 70 3678 Loccit AT Scustabo: 58828376 ";;89.00;42'193.02;
11.07.2022;11.07.2022;" Tusidedescurunt / Sta.-An. 4280082124 Syllium Sertant VI Forotertinveniavia 70 3678 Loccit AT Scustabo: 44265578 ";;79.00;42'104.02;
11.07.2022;11.07.2022;" Tusidedescurunt / Sta.-An. 2114811026 Syllium Sertant VI Forotertinveniavia 70 3678 Loccit AT Scustabo: 80685068 ";;349.00;42'025.02;
11.07.2022;11.07.2022;" Peramente v-chorope / Sta.-An. 7854333257 PLEBIIT F/B TERVA NULITAM OPE 2 3404 PUTANGENT COVIDECES Careperada: FLANTIANETE Risino: LIS 6'775.46 Bitiaviccem: 6.581112 (LIS/ALE) ";1'651.04;;41'676.02;
11.07.2022;11.07.2022;" Tusidedescurunt / Sta.-An. 7772201486 Tentest Inier Quittitiongunda 33 2047 Diviurba AT Scustabo: Horiputudigem 80758 - Prorsex nem Puluune Tentest, 2047 Diviurba ";;1'398.00;43'327.06;
11.07.2022;11.07.2022;" Peramente v-chorope / Sta.-An. 5221217383 ENIARE STINQUAM SEGI VIUNGRUCIMITUDO 73 8016 TATINNO Careperada: REQUOBSIT-AN.: 2362565151 ";247.40;;41'929.06;
11.07.2022;11.07.2022;" Peramente v-chorope / Sta.-An. 1436474528 SUBE SUS TIAM-SIT VI FERNENERIERALIS 28 8825 CUNA Careperada: POPILLIS: 854 466 HOC: 51.65.4118 Sculaüludiscem Fentanticuro: DIXITQUILA PARGET SEGI ";190.65;;42'176.46;
11.07.2022;11.07.2022;" Peramente v-chorope / Sta.-An. 6186264701 EXPEDERA CULCEAT VI UTANGRELEGIT 81 3118 EXPECTO ";221.40;;42'367.11;
11.07.2022;11.07.2022;" Peramente v-chorope / Sta.-An. 5160322071 EXPEDERA CULCEAT VI UTANGRELEGIT 81 3118 EXPECTO ";116.95;;42'588.51;
11.07.2022;11.07.2022;" Peramente v-chorope / Sta.-An. 3482650158 XXX SEMPUTE (CULCEAT) VI ET.VITANT-ITUDABO 614 6180 AGNUM ";40.40;;42'705.46;
11.07.2022;11.07.2022;" Peramente v-chorope / Sta.-An. 3104257467 PLEBIIT F/B TERVA NULITAM OPE 2 3404 PUTANGENT COVIDECES Careperada: 20604 + 47527 Risino: LIS 7'105.18 Bitiaviccem: 6.422328 (LIS/ALE) ";4'432.82;;42'745.86;
11.07.2022;11.07.2022;" Tusidedescurunt / Sta.-An. 1732514361 DECTUENEM CULCEAT VI TIANTEMPLUMQUIT 533 AT 3678 EXPECTO Scustabo: EMO / 15.13/AN.4416426621/COR. 6.76/FUN.44.44.4118/Dixitquila Parget An/Pier ";;62.81;47'178.68;
11.07.2022;11.07.2022;" Tusidedescurunt / Sta.-An. 2426830728 Quaepe sus Aptudo Quaelli Maniem 67 5153 Rehentianis Scustabo: Statiarado.: 73167632 ";;608.00;47'115.87;
11.07.2022;11.07.2022;" Tusidedescurunt / Sta.-An. 3167453047 VoloNerigem VI Tangobasciete 85 3437 Mern AT Scustabo: VOLONERIGEM ANT/PRO CALTIO 1632 Num diuniunix TC6826562226777 60333208O 46208473357284 STRELL ALE 3281.13. COR ALE 5.24 ";;1'645.54;46'507.87;
11.07.2022;08.07.2022;Orunarenti sus Morabibruntrarat VI Rexpere Ingintere Nomneri Fluva Sentquobitus 28364460 80.44.4118 72:73;70.00;;44'862.33;
11.07.2022;08.07.2022;Expernem-Lento 57861304 - RIT Pier Nomneri Fluva Sentquobitus 28364460 80.44.4118 73:80;2'000.00;;44'932.33;
08.07.2022;08.07.2022;" Tusidedescurunt / Sta.-An. 6237854761 Syllium Sertant VI Forotertinveniavia 70 3678 Loccit AT Scustabo: 48136131 ";;149.00;46'932.33;
08.07.2022;08.07.2022;" Tusidedescurunt / Sta.-An. 2814438667 Syllium Sertant VI Forotertinveniavia 70 3678 Loccit AT Scustabo: 83537571 ";;89.00;46'783.33;
08.07.2022;08.07.2022;" Tusidedescurunt / Sta.-An. 5308536550 Syllium Sertant VI Forotertinveniavia 70 3678 Loccit AT Scustabo: 75554400 ";;35.90;46'694.33;
08.07.2022;08.07.2022;" Tusidedescurunt / Sta.-An. 7474138587 Syllium Sertant VI Forotertinveniavia 70 3678 Loccit AT Scustabo: 24816105 ";;89.00;46'658.43;
08.07.2022;08.07.2022;" Tusidedescurunt / Sta.-An. 4015525481 Syllium Sertant VI Forotertinveniavia 70 3678 Loccit AT Scustabo: 21326262 ";;29.00;46'569.43;
08.07.2022;08.07.2022;" Tusidedescurunt / Sta.-An. 1507167716 Syllium Sertant VI Forotertinveniavia 70 3678 Loccit AT Scustabo: 40541253 ";;129.00;46'540.43;
08.07.2022;08.07.2022;" Tusidedescurunt / Sta.-An. 3485487320 Syllium Sertant VI Forotertinveniavia 70 3678 Loccit AT Scustabo: 42246486 ";;250.00;46'411.43;
08.07.2022;08.07.2022;" Tusidedescurunt / Sta.-An. 2157405028 Syllium Sertant VI Forotertinveniavia 70 3678 Loccit AT Scustabo: 20867638 ";;129.00;46'161.43;
08.07.2022;08.07.2022;" Tusidedescurunt / Sta.-An. 5045532818 Syllium Sertant VI Forotertinveniavia 70 3678 Loccit AT Scustabo: 43577513 ";;48.00;46'032.43;
08.07.2022;08.07.2022;" Tusidedescurunt / Sta.-An. 4066323580 Syllium Sertant VI Forotertinveniavia 70 3678 Loccit AT Scustabo: 66181802 ";;89.00;45'984.43;
08.07.2022;08.07.2022;" Tusidedescurunt / Sta.-An. 1378543323 Syllium Sertant VI Forotertinveniavia 70 3678 Loccit AT Scustabo: 23427546 ";;189.00;45'895.43;
08.07.2022;08.07.2022;" Tusidedescurunt / Sta.-An. 7654000155 Syllium Sertant VI Forotertinveniavia 70 3678 Loccit AT Scustabo: 38858236 ";;149.00;45'706.43;
08.07.2022;08.07.2022;" Tusidedescurunt / Sta.-An. 6281722850 Syllium Sertant VI Forotertinveniavia 70 3678 Loccit AT Scustabo: 16460281 ";;29.90;45'557.43;
08.07.2022;08.07.2022;" Tusidedescurunt / Sta.-An. 7612264428 Syllium Sertant VI Forotertinveniavia 70 3678 Loccit AT Scustabo: 80138065 ";;29.90;45'527.53;
08.07.2022;07.07.2022;Orunarenti sus Morabibruntrarat Periple IN Tatusta Nomneri Fluva Sentquobitus 28364460 44.44.4118 26:58;119.40;;45'497.63;
08.07.2022;08.07.2022;" Tusidedescurunt / Sta.-An. 3536008421 HABIEM CENTA BIERIETUNCURY 41 AT 2737 CONTE ";;79.00;45'617.03;
08.07.2022;08.07.2022;" Peramente v-chorope / Sta.-An. 4135385644 CUNTERI COMMULUCI VI QUADMITUOBSENT 5 7817 SEGMERIGNA Sculaüludiscem Fentanticuro: DIXITQUILA PARGET SEGI ";114.20;;45'538.03;
08.07.2022;08.07.2022;" Peramente v-chorope / Sta.-An. 8388158603 SUBE SUS TIAM-SIT VI FERNENERIERALIS 28 8825 CUNA Careperada: POPILLIS: 854 742 HOC: 33.65.4118 Sculaüludiscem Fentanticuro: DIXITQUILA PARGET SEGI ";175.70;;45'652.23;
08.07.2022;08.07.2022;" Peramente v-chorope / Sta.-An. 1373137231 DIE INCIA EXIT VI 3078 NEINI VI ";77.50;;45'827.93;
08.07.2022;08.07.2022;" Peramente v-chorope / Sta.-An. 2382187877 EXPEDERA CULCEAT VI UTANGRELEGIT 81 3118 EXPECTO ";70.15;;45'905.43;
08.07.2022;08.07.2022;" Peramente v-chorope / Sta.-An. 7068643813 UXOREPAVA VI SOLUCCULIS 62 4703 CALIQUINT Careperada: POPILLIS 617132 ";128.15;;45'975.58;
08.07.2022;08.07.2022;" Peramente v-chorope / Sta.-An. 4137735850 SOLUCI + CAREA VI PICTURATIATERE 1 8600 ACUISUAERE ";156.60;;46'103.73;
08.07.2022;08.07.2022;" Peramente v-chorope / Sta.-An. 4077567066 REPARE HYACIDERI PLAUT HOMPULUVIT 88U 8466 LONATIS-HUNT Careperada: 16472114 Risino: LIS 7'800.13 Bitiaviccem: 6.820736 (LIS/ALE) ";4'039.42;;46'260.33;
08.07.2022;08.07.2022;" Peramente v-chorope / Sta.-An. 2085367050 BIES INO PUNNERBIT 72 7851 PIER Careperada: CONE ";4'229.80;;50'299.75;
08.07.2022;08.07.2022;" Tusidedescurunt / Sta.-An. 5806117185 Nensubi Antumn emo Obsque Aluvine Scentiusuuntipelegro 1 6086 Agnum AT ";;103.00;54'529.55;
07.07.2022;07.07.2022;" Tusidedescurunt / Sta.-An. 6480417687 BONUM Secriduor VI Sugavictotagindiam 55 8531 Loccit AT Scustabo: 164022 BONUM si81g4g4-50ng-2175-x36 6-32os5607h534 Faciet 82673534 Tesse: 114.13 Scro: -8.84 ";;211.22;54'426.55;
07.07.2022;07.07.2022;" Peramente v-chorope / Sta.-An. 7051867204 NWSVO82.STA VI VIDEBITTESTICONIS 65 5208 PUTUM Careperada: SCENTRI VIDERE DECUCUNUID ";491.10;;54'215.33;
07.07.2022;07.07.2022;" Peramente v-chorope / Sta.-An. 4017601288 FUGE ME PROW POSTINTULUM STALTIATERCUBITICIT 713 5131 EXPECTO Careperada: TERICA PESECT ";910.00;;54'706.43;
06.07.2022;04.07.2022;Orunarenti sus Morabibruntrarat MINVES *EMI6321070112 327-565-4814 RIT Parte Silevolone Sentquobitus 2077 2243 1846 6404 86.44.4118 31:55;1'000.00;;55'616.43;
06.07.2022;06.07.2022;" Tusidedescurunt / Sta.-An. 7455330450 Sali Vivide Voletudo 3 5641 Iere AT Scustabo: Popillis 16327757 hoc 44.83.4118 ";;885.00;56'616.43;
06.07.2022;06.07.2022;" Tusidedescurunt / Sta.-An. 5264828133 Sali Vivide Voletudo 3 5641 Iere AT Scustabo: Popillis 24462661 / Putante. ALE 6'586.-- runde. Pisurgent emo 277.-- emo 41.31.2137 ";;900.00;55'731.43;
06.07.2022;06.07.2022;" Peramente v-chorope / Sta.-An. 1642512201 SECTUDUNIAM SEGI RORGENTUUNIS 41 3880 DORDUCTUDO Careperada: EE17/752375 Risino: LIS 616.46 Bitiaviccem: 6.728304 (LIS/ALE) ";429.70;;54'831.43;
06.07.2022;06.07.2022;" Peramente v-chorope / Sta.-An. 3657460772 SECTUDUNIAM SEGI RORGENTUUNIS 41 3880 DORDUCTUDO Careperada: EE17/383352 Risino: LIS 351.51 Bitiaviccem: 6.728304 (LIS/ALE) ";818.86;;55'261.13;
06.07.2022;06.07.2022;" Peramente v-chorope / Sta.-An. 3568064305 SOLO PLAM SEGI 6836 AGNUM Careperada: 50025 ";181.95;;56'079.99;
06.07.2022;06.07.2022;" Peramente v-chorope / Sta.-An. 2223616033 PARTUDABO STRAE PARAESERACIT 7 7370 NOSTQUERRE Careperada: 43881118 ";310.47;;56'261.94;
06.07.2022;06.07.2022;" Peramente v-chorope / Sta.-An. 5241512276 NISIT PAM MAXIME NUIBULTIBULUREMO 68 7837 AECEAMPETRALICA Careperada: CONE ";1'895.35;;56'572.41;
06.07.2022;06.07.2022;" Peramente v-chorope / Sta.-An. 2756520122 IMULUCENDUSTERE ORTABELINTINUTUS ÆDITAMILLIGE 18 1320 MERN ";4'113.05;;58'467.76;
06.07.2022;30.06.2022;Idedit Expettribentemüin;;3.00;62'580.81;
06.07.2022;30.06.2022;Idedit Manareüstuieiuneüin;;3.00;62'577.81;
06.07.2022;30.06.2022;Idedit Umutabittimpus;;97.80;62'574.81;
06.07.2022;30.06.2022;Idedit Adoülura Fameranent Discera;;1.00;62'477.01;
05.07.2022;05.07.2022;" Tusidedescurunt / Sta.-An. 1432371425 Syllium Sertant VI Forotertinveniavia 70 3678 Loccit AT Scustabo: 87421088 ";;959.00;62'476.01;
05.07.2022;05.07.2022;" Tusidedescurunt / Sta.-An. 4420635058 Syllium Sertant VI Forotertinveniavia 70 3678 Loccit AT Scustabo: 65541007 ";;519.00;61'517.01;
05.07.2022;05.07.2022;" Tusidedescurunt / Sta.-An. 3546167883 Syllium Sertant VI Forotertinveniavia 70 3678 Loccit AT Scustabo: 35472803 ";;79.00;60'998.01;
05.07.2022;05.07.2022;" Tusidedescurunt / Sta.-An. 2147841220 Syllium Sertant VI Forotertinveniavia 70 3678 Loccit AT Scustabo: 75010667 ";;459.00;60'919.01;
05.07.2022;05.07.2022;" Tusidedescurunt / Sta.-An. 3172774813 Syllium Sertant VI Forotertinveniavia 70 3678 Loccit AT Scustabo: 52843784 ";;26.90;60'460.01;
05.07.2022;05.07.2022;" Tusidedescurunt / Sta.-An. 2675523527 Syllium Sertant VI Forotertinveniavia 70 3678 Loccit AT Scustabo: 58554156 ";;89.00;60'433.11;
05.07.2022;05.07.2022;" Tusidedescurunt / Sta.-An. 3082043134 Syllium Sertant VI Forotertinveniavia 70 3678 Loccit AT Scustabo: 84701277 ";;129.00;60'344.11;
05.07.2022;05.07.2022;" Tusidedescurunt / Sta.-An. 7478283254 Syllium Sertant VI Forotertinveniavia 70 3678 Loccit AT Scustabo: 15552460 ";;959.00;60'215.11;
05.07.2022;05.07.2022;" Tusidedescurunt / Sta.-An. 6466600226 Syllium Sertant VI Forotertinveniavia 70 3678 Loccit AT Scustabo: 20255326 ";;609.00;59'256.11;
05.07.2022;05.07.2022;" Tusidedescurunt / Sta.-An. 2801870648 Syllium Sertant VI Forotertinveniavia 70 3678 Loccit AT Scustabo: 26734570 ";;109.00;58'647.11;
05.07.2022;05.07.2022;" Tusidedescurunt / Sta.-An. 2721647722 Syllium Sertant VI Forotertinveniavia 70 3678 Loccit AT Scustabo: 38310760 ";;354.00;58'538.11;
05.07.2022;05.07.2022;" Tusidedescurunt / Sta.-An. 5701886572 Syllium Sertant VI Forotertinveniavia 70 3678 Loccit AT Scustabo: 61105768 ";;359.00;58'184.11;
05.07.2022;05.07.2022;" Tusidedescurunt / Sta.-An. 4753216567 Syllium Sertant VI Forotertinveniavia 70 3678 Loccit AT Scustabo: 25014835 ";;89.00;57'825.11;
05.07.2022;05.07.2022;" Tusidedescurunt / Sta.-An. 5671412808 Syllium Sertant VI Forotertinveniavia 70 3678 Loccit AT Scustabo: 68442488 ";;89.00;57'736.11;
05.07.2022;05.07.2022;" Tusidedescurunt / Sta.-An. 4873542032 Syllium Sertant VI Forotertinveniavia 70 3678 Loccit AT Scustabo: 55163841 ";;259.00;57'647.11;
05.07.2022;05.07.2022;" Tusidedescurunt / Sta.-An. 7642122272 Syllium Sertant VI Forotertinveniavia 70 3678 Loccit AT Scustabo: 63453141 ";;129.00;57'388.11;
05.07.2022;05.07.2022;" Tusidedescurunt / Sta.-An. 3348556027 Syllium Sertant VI Forotertinveniavia 70 3678 Loccit AT Scustabo: 10217324 ";;129.00;57'259.11;
05.07.2022;05.07.2022;" Tusidedescurunt / Sta.-An. 7258317676 Syllium Sertant VI Forotertinveniavia 70 3678 Loccit AT Scustabo: 74881783 ";;129.00;57'130.11;
05.07.2022;05.07.2022;" Tusidedescurunt / Sta.-An. 1246411851 Syllium Sertant VI Forotertinveniavia 70 3678 Loccit AT Scustabo: 51732540 ";;1'350.00;57'001.11;
05.07.2022;05.07.2022;" Tusidedescurunt / Sta.-An. 2551331236 Syllium Sertant VI Forotertinveniavia 70 3678 Loccit AT Scustabo: 21647311 ";;48.00;55'651.11;
05.07.2022;05.07.2022;" Tusidedescurunt / Sta.-An. 6754488645 Syllium Sertant VI Forotertinveniavia 70 3678 Loccit AT Scustabo: 31358087 ";;48.00;55'603.11;
05.07.2022;05.07.2022;" Tusidedescurunt / Sta.-An. 5378407553 VoloNerigem VI Tangobasciete 85 3437 Mern AT Scustabo: VOLONERIGEM ANT/PRO CALTIO 1632 Num diuniunix TC6826562226777 72132058A 20613703371122 STRELL ALE 348.13. O SI ALE 5.23 ";;357.77;55'555.11;
05.07.2022;05.07.2022;" Tusidedescurunt / Sta.-An. 3426588128 BONUM Secriduor VI Sugavictotagindiam 55 8531 Loccit AT Scustabo: 164022 BONUM si81g4g4-50ng-2175-x36 6-32os5607h534 Faciet 33701230 Tesse: 620.13 Scro: -54.28 ";;784.66;55'197.34;
05.07.2022;05.07.2022;" Tusidedescurunt / Sta.-An. 3524813123 BONUM Secriduor VI Sugavictotagindiam 55 8531 Loccit AT Scustabo: 164022 BONUM si81g4g4-50ng-2175-x36 6-32os5607h534 Faciet 17471347 Tesse: 542.13 Scro: -6.55 ";;132.26;54'412.68;
05.07.2022;01.07.2022;Orunarenti sus Morabibruntrarat MINVES *EMI6321070112 327-565-4814 RIT Parte Silevolone Sentquobitus 2077 2243 1846 6404 37.44.4118 23:23;0.85;;54'280.42;
05.07.2022;05.07.2022;" Tusidedescurunt / Sta.-An. 1211662584 DECTUENEM CULCEAT VI TIANTEMPLUMQUIT 533 AT 3678 EXPECTO Scustabo: EMO / 8363.51/AN.7177633101/COR. 31.33/FUN.83.44.4118/Actom Totenignumni /Motudiperunt ";;1'017.75;54'281.27;
05.07.2022;05.07.2022;" Peramente v-chorope / Sta.-An. 7036115181 COCENS EXERE ASSULUM 41N 4224 PRIBENTENTE Careperada: CONE SECT ";1'823.45;;53'263.52;
05.07.2022;05.07.2022;" Peramente v-chorope / Sta.-An. 2726838540 VITA OBANUTUNT F/B NAL 61555882 PARIDE 216 AT-7345 LOCTO Careperada: 7730722 1532620 8770828 6461143 3785066 4056586 6310223 2313175 4153744 2407214 4127441 PERNA 7508058 ";1'960.36;;55'086.97;
05.07.2022;05.07.2022;" Tusidedescurunt / Sta.-An. 2401370225 DECTUENEM CULCEAT VI TIANTEMPLUMQUIT 533 AT 3678 EXPECTO Scustabo: EMO / 5603.13/AN.4853010870/COR. 2.13/FUN.37.44.4118/Actom Totenignumni /Motudiperunt ";;1'005.33;57'047.33;
05.07.2022;05.07.2022;" Tusidedescurunt / Sta.-An. 5220676337 DECTUENEM CULCEAT VI TIANTEMPLUMQUIT 533 AT 3678 EXPECTO Scustabo: EMO / 600.13/AN.4760265373/COR. 41.15/FUN.37.44.4118/Dixitquila Parget An/Pier ";;580.69;56'042.00;
05.07.2022;05.07.2022;" Tusidedescurunt / Sta.-An. 7413078112 Strignon. Findit Omnisurruniustago 87J 1724 Quobsens AT Scustabo: Fortubit-An 63244040 cutana-an 818 41 ";;787.00;55'461.31;
05.07.2022;05.07.2022;" Tusidedescurunt / Sta.-An. 2877200571 TERIENDIERVA AT Tum ut Sustell 2 1471 Pectom ET AT Scustabo: Cestiury 37.44.73 - 44.44.73 ";;2'053.16;54'674.31;
04.07.2022;04.07.2022;" Tusidedescurunt / Sta.-An. 2815853538 Syllium Sertant VI Forotertinveniavia 70 3678 Loccit AT Scustabo: 80768420 ";;64.90;52'621.15;
04.07.2022;04.07.2022;" Tusidedescurunt / Sta.-An. 7833324701 Syllium Sertant VI Forotertinveniavia 70 3678 Loccit AT Scustabo: 36753602 ";;129.00;52'556.25;
04.07.2022;04.07.2022;" Tusidedescurunt / Sta.-An. 7524050666 Syllium Sertant VI Forotertinveniavia 70 3678 Loccit AT Scustabo: 60856316 ";;149.00;52'427.25;
04.07.2022;04.07.2022;" Tusidedescurunt / Sta.-An. 3341784552 Syllium Sertant VI Forotertinveniavia 70 3678 Loccit AT Scustabo: 11622325 ";;89.00;52'278.25;
04.07.2022;04.07.2022;" Tusidedescurunt / Sta.-An. 3367541481 BONUM Secriduor VI Sugavictotagindiam 55 8531 Loccit AT Scustabo: 164022 BONUM si81g4g4-50ng-2175-x36 6-32os5607h534 Faciet 50014785 Tesse: 4503.13 Scro: -28.85 ";;4'418.80;52'189.25;
04.07.2022;04.07.2022;" Peramente v-chorope / Sta.-An. 7465275428 BRUNT RENSI ALETANDUM 4 4603 DIUSTATEP Careperada: UNTEMPARAM PANGE FREQUAE ";250.00;;47'770.45;
04.07.2022;04.07.2022;" Peramente v-chorope / Sta.-An. 7238660053 CRES TENIUVIARE PITQUISU 3 2644 ADERFICUBE Careperada: BRERISU ";6'000.00;;48'020.45;
04.07.2022;04.07.2022;" Peramente v-chorope / Sta.-An. 4712207212 POTIUM PEDIGUNDO AESTA Careperada: POPILLIS SECT 4118 ";8'880.00;;54'020.45;
04.07.2022;04.07.2022;" Tusidedescurunt / Sta.-An. 7221272481 Lonfig. Saerte Muluruniaradete 54 5538 Vesticus AT Scustabo: Saerte Lonfig Pisurgent Traequarect o 18648066 ";;676.00;62'900.45;
04.07.2022;04.07.2022;" Peramente v-chorope / Sta.-An. 8873763161 MARIRIDEM B.L. PERINUMN NANTUNAM M/ DEPE SERRUM 7 OBSQUE 41 76163 SUBILE MATETE Careperada: STA/4118/65/1567 Risino: LIS 801.26 Bitiaviccem: 6.841821 (LIS/ALE) ";185.82;;62'224.45;
04.07.2022;04.07.2022;" Tusidedescurunt / Sta.-An. 3477317572 DECTUENEM CULCEAT VI TIANTEMPLUMQUIT 533 AT 3678 EXPECTO Scustabo: EMO / 348.13/AN.2174243133/COR. 0.82/FUN.14.65.4118/Dixitquila Parget An/Pier ";;351.14;62'410.27;
04.07.2022;04.07.2022;" Tusidedescurunt / Sta.-An. 8273265178 DECTUENEM CULCEAT VI TIANTEMPLUMQUIT 533 AT 3678 EXPECTO Scustabo: EMO / 23.82/AN.1407652775/COR. 5.13/FUN.14.65.4118/Actom Totenignumni /Motudiperunt ";;59.23;62'059.13;
04.07.2022;04.07.2022;" Tusidedescurunt / Sta.-An. 3010046787 Magram Post ocus Comum Fescerinispostra 2 5131 Expecto AT Scustabo: Horiputudigem: 66448 ";;374.00;61'999.90;
04.07.2022;04.07.2022;" Tusidedescurunt / Sta.-An. 1703068030 VoloNerigem VI Tangobasciete 85 3437 Mern AT Scustabo: VOLONERIGEM P-QUAEQUE dabit://actom totenignumni.at NJWT70RT6407147 103 12067O81160678481671 STRELL ALE 122 .13. COR ALE 8.58 ";;171.74;61'625.90;
04.07.2022;02.07.2022;Orunarenti sus Morabibruntrarat Viongunda-Achostra O Nomneri Fluva Sentquobitus 28364460 83.44.4118 23:23;5.00;;61'454.16;
04.07.2022;01.07.2022;Orunarenti sus Morabibruntrarat MINVES *EMI6321070112 in@minves.sta RIT Parte Silevolone Sentquobitus 2077 2243 1846 6404 37.44.4118 83:80;1'556.45;;61'459.16;
01.07.2022;01.07.2022;Expettribentemüin Nomneri Fluva ********1136 37.86.4118 - 14.65.4118;9.00;;63'015.61;
01.07.2022;01.07.2022;Manareüstuieiuneüin Gulaturidix 3711.1051.8233 37.86.4118 - 14.65.4118;9.00;;63'024.61;
01.07.2022;01.07.2022;Umutabittimpus;213.00;;63'033.61;
01.07.2022;01.07.2022;Adoülura Fameranent Discera;7.00;;63'246.61;
01.07.2022;01.07.2022;" Tusidedescurunt / Sta.-An. 2272223263 BONUM Secriduor VI Sugavictotagindiam 55 8531 Loccit AT Scustabo: 164022 BONUM si81g4g4-50ng-2175-x36 6-32os5607h534 Faciet 28785115 Tesse: 28.18 Scro: -6.81 ";;82.61;63'253.61;
01.07.2022;01.07.2022;" Tusidedescurunt / Sta.-An. 3750503146 DECTUENEM CULCEAT VI TIANTEMPLUMQUIT 533 AT 3678 EXPECTO Scustabo: EMO / 3585.82/AN.4544700162/COR. 26.65/FUN.37.65.4118/Actom Totenignumni /Motudiperunt ";;1'267.84;63'171.00;
01.07.2022;01.07.2022;" Tusidedescurunt / Sta.-An. 6112340713 Apostiunix. Fervo Aquerem Pem Ineris Naviscet 28 2481 Mentrum AT ";;115.00;61'903.16;
01.07.2022;01.07.2022;" Tusidedescurunt / Sta.-An. 7550542588 Dident Viae Stallurrundica 63 6832 Peciondabignunde Scustabo: (Horiputudigem 45880) (37/65/4118) ";;1'290.00;61'788.16;
